require "Utils/ColorFilter"
require "Utils/GlobalEnum"
Text = {
    TouchToMove = "触碰方向键移动",
    MoveToPosTips = "请移动到箭头处",
	AttackToPosTips = "点击使用普通攻击",
	SkillToPosTips = "点击使用技能攻击",
	RollToPosTips = "翻滚可躲避敌人攻击",
    AutoMove = "自动寻路中",
    PressContinue = "(触碰屏幕继续)",
    Colon = ":",
    Confirm = "确定",
    Cancel = "取消",
    ExitGame = "退出游戏",
    ContinueGame = "继续游戏",
    ContinueGameTips = "点击继续游戏,继续战斗",
    KingTowerContinueGameTips = "退出战斗将无法获得奖励",
    Restore = "恢复",
    Save = "保存",
    NoSave ="不保存",
    Disconnected = "网络连接失败，请重新登录",
    PingTooHigh = "您目前的网速较慢，请提高网速后再进行PK对战。建议在WiFi或3/4G网络下PK",
    StarLevel = "星级",
    Experience = "经验",
    Time = "时间",
    Award = "奖励",
    Active = "激活",
    Empty = "空",
    Use = "使用",
    Nothing = "无",
    Money = "金币",
    BlueDia = "蓝钻",
    GetDiamondAward = "领蓝钻",
    RedDia = "红钻",
    Crystal = "晶石",
    Cost = "花费",
    Item = "物品",
    TaskAward = "任务奖励",
    ClickContinue = "点击继续",
    Setting = "设置",
    Back = "返回",
    Exit = "退出",
    ClickEnter = "点击进入",
    AutoFight = "托管",
    AutoFightCancel = "取消托管",
    AutoFightIng = "自动战斗中",
    AutoFightGuidTip = "点击托管可自动战斗",
    CreatePlayer = "创建角色",
    AccountBind = "账号绑定",
    CurrentServer = "当前服务器：",
    RecommondServer = "推荐服务器",
    AccountName = "账号：",
    CustomImageUploadFailed = "头像上传失败",
    CustomImageUploadSuccess = "头像上传成功",
    CustomImageDeleteFailed = "头像删除失败",
    CustomImageDeleteSuccess = "头像删除成功",
    CustomImageDeleteDefault = "默认头像不能删除",
    CustomImageCaremaUpload = "拍照上传",
    CustomImagePhotoUpload = "相册上传",
    CustomImagePhotoDelete = "删除照片",
    CustomImageChange = "更换头像",
    ContactCustomer = "联系客服",
    CustomImageCD = "CD中，剩余%d秒",
    CanBuy = "可购买",

    MoneyNotEnough = "金币不足",
    LevelNotEnough = "等级达到%d级开放",
    SceneNotEnough = "通关%s开放",
    LevelAdd = "%d级",
    CropLevelNotEnough = "骑士团等级达到%d级开放",
    MoneyValue = "%d元",
    NoFinished = "未完成",

    Win = "胜利",
    Defeat = "失败",
    Relive = "复活",
    Level = "等级",
    CurLevel = "当前等级",
    NextLevel = "下一等级",

    LevelCanAccpet = "级可以领取",

    BattleAward = "战斗奖励",
    BackGameHall = "返回主城",
    BackGameHallAndPowerUP = "回城提战力",
    BackBattle = "返回战斗",
    BattleAgain = "再次挑战",
    SelectScene = "选择关卡",
    GiveUpBattleTips = "确定放弃？放弃将损失所有\n经验和已获得的物品。",
    SelectEffectTips = "您还可以选择提升一个属性哦,亲!",
    PVEMReliveOpenMessage = "复活再战",
    AwardForFirstPass = "首通奖励",
    SceneFeature = "关卡背景",
    RefreshCountDown = "(每日0点重置次数)",

    Click = "点击",
    Button = "按钮",

    LevelUp = "升级",
    LevelUpCost = "升级消耗",
    Talent = "天赋",
    FreeLevelResetTips = "%d级前免费重置",
    TalentPoint = "当前天赋点：",
    TalentPointGetTips = "[f7c45d](通关关卡获得三星评价奖励天赋点)[-]",
    HasMaxTalent = "[E23131](天赋已满级)[-]",
    MaxTalentLevel = "[E23131](角色达到%d级可升下一级)[-]",
    Waste = "消耗",
    ResetTalent = "天赋重置",
    ResetTalentTips = "重置所有天赋点",
    Skill = "技能",
    SkillEquip = "技能装备",
    SkillSelectTips = "选择一个栏位进行装备",
    SkillLock = "该技能未解锁",
    SkillRequireLevel = "升至下一级需要角色达到%d级",
    Lock = "未解锁",
    Hallow = "圣器",
    GotoHallow = "前往圣器",
    ClearHallowBag = "正在整理圣器背包",
    FinishedHallowBag = "整理完毕",
    AdornHallow = "显示",
    HallowSkill = "圣器技能",
    UnLock = "解锁",
    HasUnLock = "已解锁",
    UnLockLevel = "解锁等级",
    OpenLevelTips="开启等级",
    HallowSkillEquipError = "圣器技能无需手动装备",
    HallowNotOpen = "[E23131]暂未开启[-]",
    NoProperty = "无属性",
    BasicProperty = "基础属性",
    DetialProperty = "详细属性",
    HaventEquip = "未装备",
    RareDegree = "极品度:",
    OriginDegree = "初始基础属性范围",
    RareDetail = "详细",
    HallowIce = "攻击时有概率触发冰霜伤害，伤害效果取决于角色的冰伤害属性",
    HallowFire = "攻击时有概率触发火焰伤害，伤害效果取决于角色的火伤害属性",
    HallowEffectDesc = {"攻击时有概率触发火焰伤害，伤害效果取决于角色的火伤害属性","攻击时有概率触发冰霜伤害，伤害效果取决于角色的冰伤害属性"},
    LvRequire = "等级需求",
    Profession0 = "血魅",
    Profession1 = "剑狂",
    ProfessionType = "职业需求",
    Profession = "职业",
	AmulerType1 = "闪电",
    AmulerType2 = "烈焰",
    AmulerType3 = "寒冰",
    AmulerType4 = "大地",
    AmuletIce = "冰霜符文",
    AmuletFire = "火焰符文",
    AmuletLight = "圣光符文",
    AmuletEarth = "大地符文",
    Amulet = "符文",
    AddPerLv = "每级增加",
    AmuletLv  ="符文等级",
    AmuletExp = "符文经验",
    AmuletType = "符文类型",
    AmuletAttr = "符文属性",
    UseItem = "使用%s",
    HallowRefineProcess = "[3894D0]第%d重[-] 基础%s [51BF53]+%d[-]",
    HallowRefineProcess2 = "[3894D0]第%d重[-]\n基础%s [51BF53]+%d[-]",
    HallowRefineExpPrompt = "提升[51BF53]%d~%d[-]",
    HallowRefineLvPrompt = "最高强化等级需要达到%d才能继续精炼",
    HallowStrenthIron = "陨铁不足,是否花费蓝钻补足",
    AmuletMaxLV = "符文已经升级至最高等级",
    HallowSystemTips = "圣器系统未开启！",

    MainCity = "主城",
    Reset = "重置",
    Current = "当前",
    Next = "下一级",

    ChooseWipePrompt = "扫荡需要消耗扫荡卷,请选择要使用的扫荡卷",
    SceneType = "关卡类型",
    SceneLevelOfDiff = "关卡难度",
    SceneSinewNeed = "消耗精力",
    MayAward =  "可能掉落",
    MayGain = "预计获得",
    SceneBaseAward = "基础奖励",
    Sweep = "扫荡",
    SweepFast = "一键扫荡",
    SweepTime = "第%d次扫荡",
    SweepTimes = "扫荡次数:",
    SweepOrder = "第%d层扫荡",
    SweepStart = "扫荡开始",
    SweepResult = "扫荡结果",
    StartFight = "开始挑战",
    SceneStarTarget = "关卡目标",
    Nomal = "普通",
    Hard = "精英",
    StartSweep = "开始扫荡",
    NoEnoughPowerSweep = "您已经到达当前战力可扫荡层数上限",
    CanSweepLevel = "当前战力%d,可扫荡至[D7752D]%d[-]层",
    GotoMagicTower = "获取扫荡卷",
    GetWipInMagicTower = "[%s]%s[-]不足，请在魔法屋中获取",
    LevelUpNeed = "升级需要",
    WipeSelect = "设定扫荡数量",
    SweepFinished = "扫荡结束",
    AutoSell = "自动出售",
    SelectToGet = "选择领取",
    TotalAward = "总计获得",
    SweepAfterGetAward = "请先领取后再进行扫荡",
    AccumulateObtained = "累积获得",
    SweepFiveTime = "扫荡5次",
    SweepAgain = "再次扫荡",
    Get ="获得",
    StarConditionForPassScene = "战役通关",
    HardSceneCondition = "三星开启",
    GobackToFairy = "返回精灵",
    WorldMap = "世界地图",
    NeedStufForFairySweep = "[D2A848]还需[D53E52]%d[-]个[-]",
    StuffEnoughForFairySweep = "[51BF53]精灵石已足够[-]",
    SceneOpendByThreeStar = "此关卡三星后开启",
    SweepScenePrompt = "扫荡此关卡获得经验",
    WipeRatePrompt = "%d倍收益",
    CantGetPrompt = "暂无获得方式",

    SceneTypesText =
      {
          "普通",
          "限时",
          "竞速",
          "击杀",
          "波数",
          "守护",
          "击杀",
          "波数",
      },
    Nothing = "无",
    SellOneTime = "一键出售",
    Sell = "出售",
    PlayerProperty = "人物属性",
    Property = "属性",
    PlayerLevelUpExp = "升级经验",
    Equip = "装备",
    HasEquip = "已装备",
    EquipBag = "装备背包",
    EquipStrengthen = "装备强化",
    UpStep = "进阶",
    Strengthen = "强化",
    EquipWash = "洗炼",
    AttrTransfer = "转移",
    EquipWashChoosePrompt = "选择一条属性来洗炼",
    EquipWashReplacePrompt = "随机一条属性覆盖在原装备上",
    EquipWashFinished = "洗炼完成",
    OldAttr = "原属性",
    NewAttr = "新属性",
    EquipUISellEquip = "要出售的装备的品质",
    StrengthenOnTime = "一键强化",
    StrengthCost = "强化消耗",
    Player = "角色",
    LvToLvUp = "级可进阶",
    EquipSys = "装备",
    PlayerLevelAndName = "Lv.%d %s",
    StrengthNeedLevelUp = "[D53E52]强化等级不能高于角色等级，请升级。[-]",
    StrengthLevelMax = "已经强化至最高等级",
    EquipUpStepNeedLevelUp = "[D53E52]角色达到%d级可进阶[-]",
    Binded = "已绑定",
    Unbinded = "未绑定",
    Equiped = "已装备",
    RecommendEquip = "可装备",
    RecommendWash = "可洗炼",
    StartUpStar = "开始升星",
    UpStarAttr = "升星属性",
    EquipUpStar = "装备升星",
    EquipUpStarConsumeTip = "选择升星需要消耗的装备:",
    EquipUpStarTip = "先从右边选择用于升星的装备",
    AllSelectEquip = "全选紫色装备",
    NextLV = "下一星级: %s",
    ProgressText = "进度: ",
    ProgressStr = "进度: %s",
    FullStar = "装备已达满星",
    CanUpStar = "可升星",
    PleaseChooseConsumEquip = "请选择要吞噬的装备",
    ProgressAdd = "升星进度增加",
    UpStarCost = "装备升星消耗",
    Consume = "消耗：",
    consumTips = "没有可吞噬的装备",
    EquipWashEmpty = "洗炼装备不存在,请重试",

    BagReachUpperLimit = "背包达到上限，请先清理背包",

    StarLevelTitle = "升星等级",
    StarExpTitle = "升星经验",
    StrengthAttrTitle = "强化属性",
    WashAttrTitle = "洗炼属性",
    GroupAttrTitle = "套装",
    NeedLevelTitle = "需求等级",
    NeedProfessionTitle = "需求职业",
    EquipGroupAttrContent1 = "[%s]%d件  %s  +%d[-]",
    EquipGroupAttrContent2 = "[%s]      %s  +%d[-]",
    SweepSccess = "扫荡成功",
    StrengthSuccess = "强化成功",
    UpStepSuccess = "进阶成功",
    Attribute = "属性",
    EquipStrengthenPrompt = "[D4E4EE]替换装备不会降低强化等级[-]",
    SellItemPrompt = "是否确定出售",
    SellItemSecondPrompt = "出售物品中包含珍贵物品，是否确定出售？",
    SellItemQualityPrompt = "请选择需要出售的物品的品质",
    RestoreCostTenDiamond = "10蓝钻",
    RestoreSuccess = "恢复成功",
    EquipAttrExchangeSuccess = "装备属性转移成功",
    GoCurrentNow = "立即前往",
    GainScene = "在%s掉落",
    SceneClosed = "关卡尚未开启",
    StufDropWithSceneClosed = "在%s掉落，关卡尚未开启",
    RoleNotEquiped = "尚未装备",
    ClosedForLevel = "%d级开启",
    PlayerCanLevelUp = "可升级",
    PrePage = "上一页",
    NextPage = "下一页",

    Base = "基础",

    AwardObtainedPrompt = "奖励已领取",
    AwardLockedPrompt = "尚未达到领取条件",

    PowerWithValue = "战力 %d",

    QualityGrey = "灰色",
    QualityWhite = "白色",
    QualityGreen = "绿色",
    QualityBlue = "蓝色",
    QualityPurple = "紫色",
    QualityOrange = "橙色",

    QualityPurpleAbove = "紫色及以上",

    AttackAttr = "攻击",
    DefenseAttr ="防御",
    LifeAttr = "生命",

    BuySinewPrompt = "购买50精力",
    BuySinewPrompt2 = "(可用于通关精英副本，获取大量灵力)",
    SinewFullPrompt = "[3894D0]精力已满，精力消耗后将自动恢复[-]",
    SinewCountDown = "[3894D0]下次自动恢复时间\n[-][D4E4EE]%s[-]",
    BuyMaxForVipPrompt = "已达购买上限，继续购买请提升VIP等级",
    BuyWipePrompt = "购买3个扫荡卷",

    PlayerAlreadyInCity = "您已经在当前主城中",
    CityLocked = "等级不足，无法进入此主城",
    Vip8ContextLabel = "高端VIP玩家获取最新游戏资讯服务请添加QQ800061511\n",

    NumberText = {
        "一",
        "二",
        "三",
        "四",
        "五",
        "六",
        "七",
        "八",
        "九",
        "十",
    },
    Gem = "宝石",
    GemStoneDesc = "宝石描述",
    GemStoneAttr = "宝石属性",
    GemStoneType = "宝石类别",
    GemStoneCompose = "蓝钻补足直接升级",
    OneKeyForInlay = "一键镶嵌",
    GemPuton = "镶嵌",
    GemPutoff = "卸下",
    GemTypeDesc = {
      "红宝石","黄宝石","蓝宝石","多彩宝石",
    },
    RubyGemPart = "红宝石槽",
    TopazGemPart = "黄宝石槽",
    SapphireGemPart = "蓝宝石槽",
    ColorfullGemPart1 = "多彩",
    ColorfullGemPart2 = "宝石",
    CostToOpenGemPart = "开启此槽位需要消耗%s,是否要开启？",
    OpenGemPartPrompt = "是否开启此槽位并激活1级宝石",
    MaxGemInBagPrompt = "背包内存在更高等级的宝石可直接替换",
    PutOnGemNoEquip = "无装备,不能镶嵌",
    PutOnGemFailForGemPart = "镶嵌失败，槽位尚未开启",
    MaxLevelPrompt = "宝石已满级",
    GemNotEnoughCompose = "宝石精华不足",
    GemReplacePrompt = "可替换",
    GemNotEnough = "宝石精华不足",
    GemPartOpenForClick = "点击开槽",
    GemCostPrompt = "[%s]%s %d/%d[-]",
    GemAttrAdd = "宝石属性加成",
    GemComposeNeedVip = "VIP3以上可使用蓝钻替代升级",
    ColorfullGemOpenMat = "前往骑士团驯兽商店，兑换对应部位的开孔符",
    ColorfullGemLockForBoss = "已达上限，通关驯兽BOSS[%s]%s[-]后，可继续升级",
    OnlyLeaderCanAnounce = "只有团长和副团长可以通知他人",

    NDBShopBuyPrompt = "购买%s",
    NDBShopBuySuccess = "购买%s成功",
    NDBShopTitle = {
      [ShopType.Gem] = "宝石商店",
      [ShopType.Dragon] = "屠龙商店",
      [ShopType.KiloTower] = "千层塔商店",
      [ShopType.CastleDefend] = "守卫皇城商店",
    },

    ItemDesc = "物品描述",

    SoulBattle = "魔魂试炼",
    BuySoulBattleCount = "购买一次挑战次数",
    ResetSoulBattle = "重置挑战次数",
    SoulBattleCountMax = "挑战次数已达上限",
    SoulBattleNoTimes = "魔魂试炼挑战次数不足",
    DayCountRestMax = "已达重置上限,继续重置请提升VIP等级",
    SoulBattleSystemTips = "魔魂试炼系统未开启！",
-----------------------------Login登录验证-------------------------------------------
    ServerListError="服务器列表下载失败,请重试",
    ConnectError="连接服务器失败,请检查网络",
    DownLoadServerOverTime = "连接服务器超时，请重新下载！",
    DownloadNoticeFail = "下载公告失败,请检测网络状!",
    RetryText="重试",
    AccountsErrorString = "LK",
    AccountsTips = "请输入您的账号",
    PasswordTips = "请输入您的密码",
    AccountsRegister="注册",
    AccountsLogin="登录",
    LoginUserName="用户名",
    LoginUserPassword="密   码",
    RegisterInputPword="输入密码",
    RegisterConfirmPword="确认密码",
    -- AccountsExist = "帐号已存在",
    -- PasswordError = "密码错误",
    AccountsFormError = "用户名格式不对",
    PasswordFormError = "密码格式不对",
    PasswordInconsistent = "新密码与确认密码不一致",
    AccountsLeastNum = "账号最少6位",
    PasswordLeastNum = "密码最少6位",
    AccountsLongestNum = "账号最长31位",
    PasswordLongestNum = "密码最长31位",
    DefaultRoleName="王者2归来",
    DefaultDaJianName="剑狂",
    DefaultLianDaoName="血魅",
    DefaultYouXiaName="游侠",
    StartGame="开始游戏",
    LoginGame="账号",
    EnterGame="进入",
    CreateRoleName="用户名格式不对,请输入英文(10个)、数字(10个)或中文(6个)",
    DelRole="删除角色",
    LoginName="登录账号:",
    Maintain = "(维护中)",
    ServerList = "服务器列表",
     RoleDescribTable = {
        [0] = "魔法与利刃的融合",
        [1] = "技艺超群的巨剑士",
        [2] = "崇尚自然的神射手",
    },
    InstanPower = "爆发能力",
    AttackRange = "攻击范围",
    MoveAbility = "移动能力",
    SwitchServerOnClick = "点击换区",
-----------------------------SignIn-------------------------------------------
    FULLSignInAward = "满勤奖",
    FULLSignAward = "满勤奖励",
    AddSignInByMonth = "本月累计签到",
    SignInAward = "签到有礼",
    SignInShop = "积分商店",
    SignInCount = "累计签到 %d/%d",
    SignInFlagLable = {
        [1] = "可签",
    	[2] = "已签",
    	[3] = "补",
    },
    SignInAwardCount = "第%d次签到奖励",
    SignIn = "签到",
    NoAchieve = "未达到",
    PatchSignIn = "补签",
    FinishedSignIn = "已签到",
    CritMultipleAward = "签到时有概率出暴击\n暴击可获得多倍奖励",
    CritMultipleAwardDes = "签到时获得%d倍暴击",
    NotCritMultipleAwardDes = "没有获得暴击效果",
    VipCritMultiple = "V%d必爆",
    PatchSignInTips = "补签需要",
    CritMultiple = "暴击 X%d",

-----------------------------RefreshShop-------------------------------------------
    SecretShoper = "神秘宝箱",
    SecretShop = "神秘商店",
    NormalShop = "商店",
    TreasureShop = "宝箱商店",
    GhostShop = "魔魂商店",
    DragonShop = "屠龙商店",
    GradeLimiting = "[%s]%d级可购买[-]",
    AutoRefreshTime = "免费刷新次数 %d/%d  %s",
    RefreshSchedule = "今日剩余%d次",
    RefreshTips = "消耗:%d     或刷新令%d/1",
    MysticalStone = "神秘晶石: ",
    MysticalPass = "当前刷新令: ",
    Refresh = "刷新",
    WhatTimeRefresh = "今日%d点刷新",
    NextDayToRefresh = "明日%d点刷新",
    Buyed = "售罄",
    Buy = "购买",
    BuySuccess = "购买成功！",
    ResetCountDown = "刷新倒计时:%s",
    ------------------------------------战斗结算------------------------------------
    PlayerDeadSimpleInfo = "胜败乃兵家常事,提升战力后再来挑战吧!",
    ReliveTips = "请选择一个属性加成进行复活",
    BuyTimeTips = "复活后获得属性加成并增加%d秒时间",
    ScenePassFrist = "(首通)",
    FirstScenePass = "首次通关",
    BuyCount = "(剩余%d/%d)",
    BuyFinished = "售完",
    --BuyTime = "购买时间",

    ----------------------------------不同关卡中的显示提示--------------------------
    InvalidSceneMsg = "需要配置表配置玩法类型",
    NormalScene = "普通关卡",
    RemainTime2 = "剩余时间",
    CostTime = "已用时间",
    EnemyTimes = "怪物波数",
    EnemyCount = "击杀数量",
    GateDefence = "守护关卡",
    CurrentScene = "当前关卡",

    DayFree = "本次免费",
    Lv = "Lv.",
    LvWithLevel = "Lv.%d",
    Boss = "Boss: ",

    ---------loginUI-----------
    RemoveRolePrompt = "亲，确定删除吗？",
    NullRolePrompt = "请先创建一个角色",
    RoleCreateTitle="角色名：",

    --------fairyUI------------
    FairyActivePrompt = "探索未完成",
    NoEquip = "无装备",
    CanGet = "可获取",
    CanGetClick = "点击获取",
    CanGetClickEquip = "点击装备",
    CanGetClickCom = "点击合成",
    Decoration ="精灵石",
    DevelopBtnText = "培养",
    HighDevelop ="高级培养",
    DevelopBtnTenText = "培养十次",
    NeedActiveFairy = "请先激活精灵",
    FairyUnlockLevel = "培养程度",
    FairyActiveSuccess = "成功激活精灵",
    FairyMultiple = "暴击倍数 X ",
    MultipleReiki = "暴击 +%d",
    NoBattleFairy="无出战精灵",
    EquipNotEnough="精灵石不足",
    FairyEquipCount = "拥有["..ColorFilter.ItemQuality[EItemQuality.Green].."]%d[-]件",
    FairyRedCount = "拥有["..ColorFilter.ItemQuality[EItemQuality.Red].."]%d[-]件",
    MaxStarLv = "已升到最大星级。",
    UpStar = "升星",
    UpStarEffect = "升星效果：",
    SkillEffect = "技能效果：",
    UpStarSuccess = "升星成功",
    FairyTitle = "精灵",
    FairyBag = "精灵背包",
    FairySetting ="技能设置",
    FairyActiveDesc = "精灵已解锁，请点击激活。",
    MoneyBtnText = "金币激活",
    DiamondBtnText = "蓝钻激活",
    GotoDevelop = "前往培养",
    NotAvailable = "暂无",
    Developing = "培养中",
    GetWay = "获取方式",
    Complex = "合成",
    PleaseSelect = "请先选择",
    LockLv = "[D53E52]%d级解锁[-]",
    StepLv = "%d阶%d级",
    Mine = "我的",
    FairyList = "精灵列表",
    Battling = "出战中",
    Follow="跟随",
    Battle = "出战",
    UpLevelSuccess = "升级成功",
    BattlePrompt = "出战个数已满",
    ActiveRecord = "激活记录",
    AttachAttr = "总附加属性",
    FairyAttachAttr = "附加主角属性",
    FairyMaterial = "升星材料",
    UnlockNewFairy = "%d阶%d级激活精灵",
    EveryTrainCost = "每次培养花费",
    EveryActiveCost = "每次激活花费",
    Activing = "激活中...",
    Congratulation = "恭喜，精灵已激活",
    FairyBag = "精灵背包",
    AbilityScene = "精英关卡",
    Reiki = "灵气:",
    GainReiki="培养+%d灵气",
    GainSuccess = "培养成功 +%d灵气",
    GainActive = "激活+%d",
    UpStarPrompt = "还差%d个%s可升星",
    FairyUpLv="精灵升级",
    FairyItemNotEnough = "精灵石不足",
    UpStarSpecial = "升星特性",
    UpStarDesc = "(%s星后开启)",
    SkillSetting = "技能设置",
    UpStarTitle = "升星预览",
    BattleSkill = "【出战技能】",
    FairyBattleSkill = "出战技能",
    TotalAdd = "【精灵总加成】",
    FairyTotalAdd = "精灵总加成",
    TrainAttachAttr = "培养附加主角属性",
    AllFairyAttrOverlying = "所有精灵的属性全部叠加在主角身上",
    SelectFairyBattleSkill = "勾选出战可选择您要携带的精灵技能（最多可出战3个精灵）",
    AutoFairyFollow = "%s已自动跟随您,尽快培养吧!",
    SceneLock = "对应主线副本未解锁",
    SecretLock = "未通关",
    SecretDevelop = "激活中",
    FirstDeveloper = "首次探索者",
    FairyStarReset = "升星重置",
    GodFairy = "神圣精灵",
    NormalFairy = "自然精灵",
    FairyBattleExitTips = "退出后将重置挑战进度，确定退出？",
    FairyStarResetDesc = "重置升星返还全部消耗的精华",
    FairySystemTips = "精灵系统未开启！",
    FairyTrainTips = "无可培养的精灵！",
--------------Ghost-------------------
    GhostNoEquip="无装备",
    GhostTip = "魔魂装备",
    GhostEquipCount = "拥有["..ColorFilter.ItemQuality[EItemQuality.Green].."]%d[-]件",
    GhostRedCount = "拥有["..ColorFilter.ItemQuality[EItemQuality.Red].."]%d[-]件",
    GhostBattling = "出战",
    GhostEquip = "装备",
    GhostUpLoad = "取消出战",
    GhostReplace = "替换",
	GhostHave = "拥有",
    GhostLimit = "背包上限",
    GhostChip = "碎片材料",
    GhostChipTitle = "碎片",
    GhostComplex = "合成",
    GhostGetWay = "获取",
    GHostBreak = "突破",
    GhostStep = "阶",
    GhostRecover = "回收",
    GhostBreakUp="分解",
    GhostReborn = "重生",
    GhostShop = "魔魂商店",
    GhostAltar = "魔魂召唤",
    GhostSkill = "技能",
    GhostNeed="需要",
    GhostBattleEnough="魔魂出战个数已满",
    GhostAutoAdd = "自动添加",
    GhostAdd = "添加",
    NoGhostList = "没有合适的魔魂可重生(需非出战的培养过的魔魂)",
    NoRecoverGhost = "没有可分解的魔魂",
    NoSellGhost = "没有可出售的魔魂",
    NoUpGhost = "没有可吞噬的魔魂",
    GhostMaxCount = "选择已满",
    GhostAdded = "已添加",
    PleaseUpSelect = "请选择升级材料",
    GhostNeedMoney = "需要金币:%d",
    GhostNeedGhost = "需要魔魂:%d个",
    GhostNeedElixir = "需要突破丹:%d个",
    GhostNeedLevel = "[D4E4EE](需要魔魂[%s]%d[-]级)[-]",
    GhostNeedDiamond = "需要蓝钻:%d个",
    GhostSacDesc = "再高级召唤["..ColorFilter.ItemQuality[EItemQuality.Green].."]%d[-]次,必出%s魔魂",
    GhostMustSac = "本次必出%s魔魂",
    GhostDiamondTime = "%s:%s:%s后免费",
    GhostSameNotBattle="技能相同的魔魂不能同时出战。",
    GhostPleaseWaite = "请稍等",
    GhostRecoverFail = "分解失败，请重新操作",
    GhostHuman = "(人形类)",
    GhostWild = "(野兽类)",
    GhostDevil = "(恶魔类)",
    FreePutOut = "免费抽取",
    CanBreak = "可以突破",
    CallSoulToken = "召魔令",
    PleaseSelect = "请先选择",
    BattleGhost = "出战魔魂",
    BattleGhosting = "出战中",
    RecommentGhost = "推荐",
    NextGhostBattle = "%d级可出战第%d个魔魂",
    ChipComplexSuccess = "合成成功",
    UpStarNotEnough = "升星装备不足",
    GhostUpStar = "魔魂升星",
    PreciousGhost = "选中魔魂中包含蓝色及以上魔魂，是否继续？",
    EnableStar = "星后开启",
    GhostAttr = "魔魂属性",
    BreakEffect = "突破效果",
    TextOr = "或",
    TextAnd = "和",
    RestMoneyCount = "剩余次数 %d/%d",
    AddExtraExp = "+%d经验",
    NoBattleGhost = "无出战魔魂",
    GhostArmy = "魔魂出战组合推荐",
    GhostArmyDesc = "(推荐出战同类型魔魂，可大幅提升战力)",
    GhostGroup = "出战推荐",
    GeneralCall = "普通召唤",
    GeneralCallTen = "普通召唤X10",
    SpecialCall = "高级召唤",
    SpecialCallTen = "高级召唤X10",
    RebornDesc = "重生后返还魔魂及所有培养材料",
    RecoverDest = "分解魔魂给予大量魔晶并返回培养材料",
    ValueChapter = "第%s章",
    GetMoney = "获得金币 %d",
    PleaseSelectSellGhost = "请选择出售的魔魂",
    GhostUpLvDesc = "蓝色和蓝色以上魔魂建议分解成     魔晶使用",
    GhostSellDesc = "白色和绿色魔魂可以出售",
    GhostRebornDesc = "紫色和橙色魔魂可以重生",
    GhostRecoverDesc = "蓝色和蓝色以上魔魂可以分解",
    GhostSystemTips = "魔魂系统未开启！",
-------------FairySecret---------------
    DayBestGrade = "今日最好成绩",
    YesterDayRank = "昨日排名",
    YesterDayRankTitle = "昨日排行榜",
    Introduce = "玩法介绍",
    LookUp = "查看",
    SecretRankAward = "排名奖励",
    FairySecretRank = "排名",
    FairySecretRole = "角色",
    FairySecretScore = "%d分",
    YesterdayBestScore = "最高得分",
    BestScoreValue = "第1名:%d分",
    RankValue = "第%s名",
    RankNumValue = "第%d名",
    ProgressScore = "进度分",
    TimeScore = "时间分",
    ReliveCount = "复活次数",
    RemainBlood = "剩余血量",
    SecretAward = "奖励",
    KillAward = "击杀奖励",
    BattleMessage = "开始挑战",
    FirstAward = "首通奖励",
    SecretSwitch = "切换",
    FairySecret = "精灵试炼",
    CurrentScore = "本场成绩",
    CurrentRank = "本场排名",
    GetOver = "距离超越",
    SecretLevel = "%d级开启",
    PassSecretActive = "通关%s后激活",
    NoChallenge = "未挑战",
    SecretNoRank = "无排名",
    ActiveSecretFairy = "解锁了%s精灵",
    FairySecretHelp = "[3894D0]活动时间：\n[-]"..
	                    "每日全天\n\n"..
	                    "[3894D0]基础规则：\n[-]"..
                        "1.首次解锁功能时，玩家被自动分配到一个小组。\n"..
                        "2.每个小组最多由6人组成。\n"..
						"3.每个秘境由5个关卡组成，玩家只能依次挑战。\n"..
						"4.切换关卡后，角色血量不会被重置。\n"..
						"5.每日挑战次数不限，以当天最好的挑战成绩进行排名。\n"..
                        "6.晚上23:50~次日0:00之间不能挑战。\n"..
						"7.挑战成绩会根据挑战进度和消耗时间进行评估。\n\n"..
						"[3894D0]活动奖励：\n[-]"..
						"1.首次通关某个秘境可以获得对应的精灵。\n"..
						"2.每日首次击杀秘境Boss可获得击杀奖励。\n"..
                        "3.每日晚上23:50~次日0:10之间，系统会根据小组排名结算奖励并重新分组。\n\n"..
						"[3894D0]精灵开启等级：\n[-]"..
                        "45级开启曙光秘境挑战，通关后获得曙光精灵\n"..
                        "60级开启皎月秘境挑战，通关后获得皎月精灵\n"..
                        "70级开启星辰秘境挑战，通关后获得星辰精灵\n",

-------------Hallow--------------------
    WetherRemoveOrNot = "是否分解：",
    NeverRemind = "不再提示",
    UsingStoneNoCutLv = "(用保底石强化，失败不降级)",
    StoneStrengthNotEnough = "保底石不足",
    OwnNumNow = "当前拥有：",
    ContinueStrength = "继续强化",
    UsingStoneStrength = "保底强化",
    Aremove = "提炼",
    AremovePreView = "提炼预览",
    AremoveTips = "圣器提炼后消失",
    TaskFinish = "[完成] ",
    HallowSys = "圣器",
    ReturnHallow = "返回圣器",
    AlreadyTopLv = "已满级",
    FirstElement = "第一重",
    SecondElement = "第二重",
    ThirdElement = "第三重",
    HistoryMax = "此圣器历史最高 +",
    LvtoUnLock = "级解锁",
    HollowFire = "火圣器",
    IceHallow = "冰圣器",

    Mixonetime = "一键融合",
    EmbedAmulet = "镶嵌符文",
    HallowSkill = "圣器技能",
    HallowEffect = "圣器效果",

    HallowRemove = "分解",
    HallowPutOff = "卸下",
    OneKeyToAdd = "一键添加",
    SwitchToStrength = "进入强化",
    SwitchToRefine = "进入精炼",
    GoToAmulet = "进入符文",
    GoToAmuletWithMultiLine = "进入\n符文",
    HallowRefine = "圣器精炼",
    StartRefine = "开始精炼",
    AremoveTips = "提炼后圣器消失",
    Progress = "进度",
    SelectedItemToRefine = "请选择一个材料进行精炼",

    DecomposeItemPrompt = "强化10级以上提炼可以返还部分材料，是否分解？",
    DecomposeItemSecondPrompt = "分解的物品中包含珍贵物品，是否确定分解？",
    DecomposeItemQualityPrompt = "请选择要分解的物品的品质",
    DecomposeOneKey = "一键分解",
    RemoveOneKey = "一键卸下",
    HallowAmulet = "圣器符文",
    SwitchHallow = "切换圣器",
    NoOrangeToRefine = "暂无橙色圣器用于精炼",
    ExChange = "替换",
    HallowStrengthText = "圣器强化",
    Need = "需要",
    Shengyushi = "保底石",
    NowHave = "当前拥有",
    UplvFaild = "升级失败",
    UplvSuccess = "升级成功",
    NoEmptyAmuletPart = {"没有空余的圣光符文槽","没有空余的火焰符文槽","没有空余的冰霜符文槽","没有空余的大地符文槽"},
    OnlySameTypeCanTake = "只有同类符文可装备",
    PleaseChooseAmulet = "请选择要吞噬的符文",
    Max5 = "每次最多只能吞噬5个符文",
    Max1 = "只能选择一个圣器精炼",
    DecomposeReward = "分解获得",
    SwitchHallow = "切换圣器",
    StrengthFail = "强化失败",
 -----------award---------------------------
    Goto = "前往",
    Vitality = "活跃度",
    LeftVitalityAward = "还差%d点领取",
    Achievement = "成就",
    NotOpen = "功能暂未开放",
    TakeAward = "领取",
    GetAward = "可领取奖励",
    FinishedAward = "宝箱已领取完",
    NotReached = "未达成",
    Reached = "已完成",
    AwardTaked = "已领取",
    CanTakeAward = "可领取",
    AwardTakeSuccess = "奖励领取成功",
----------------RankingList-------------------------
    RankingType =
    {
        [1] = "等级排行榜",
        [2] = "战力排行榜",
        [3] = "骑士团排行榜",
        [4] = "驯兽排行榜",
        [5] = "鲜花排行榜",
    },
    RankingDes = "%s: %d",

    NotRank = "暂未上榜单!",
    NoRanks = "未上榜",
    FlowerRankAward = "鲜花周榜军团奖励",
    FlowerRankAwardDes = "鲜花榜第一名的获得者，其所在的骑士团所有成员都可获得一份奖励",
    WeekAward = "本周奖励:",

----------------Announcement-------------------------
    Announcement = "公告",
----------------HelpUI-------------------------
    Help = "小助手",
    HelpType = {
        [1] = "我要升级",
        [2] = "我要变强",
        [3] = "我要精灵",
        [4] = "我要圣器",
        [5] = "我要魔魂",
        [6] = "我要宝石",
    },
    NotEnough = "%s不足",
    GetSource = "%s获得途径:",
    MoreSource = "更多途径:%s",

------------------------ActiveCode--------------------------
    ActiveCode = "兑换码",
    Cash = "兑换",
    PlaceInputActiveCode = "点击此处输入兑换码",
----------------task-------------------------
    AlreadyTake = "[已接]",
    AlreadyComplete = "[完成]",
    CanTake = "[可接]",
    Welcome = "欢迎光临 我的朋友",
    TaskTip = "[任务]",
    Continue = "继续",
    TakeTask = "接受任务",
    CompleteTask = "完成任务",
    LevelCanAccpetTask = "级可接",
 -------------FashionSys-----------------------
    FashionSys = "时装",
    Weapon = "武器",
    Clothes = "衣服",
    Wing = "翅膀",
    Shoes = "鞋子",
    Necklace = "项链",
    Ring = "戒指",
    Armet = "头盔",
    FashionMagic = "时装幻化",
    FashionDevelop = "时装培养",
    UpStep = "进阶",
    Step = "阶",
    Preview = "预览",
    Magic = "幻化",
    Advance = "提升",
    UpStepPrompt = "确定要进阶吗？",
    NoConsume = "无消耗",
    FirstRecharge = "首充奖励",
    VIPLV="vip等级:%d级",
    FashionLv="等级:%d级",
    LvAttachAttack = "附加基础攻击%.1f%%(+%d)\n",
    LvAttachDefense = "附加基础防御%.1f%%(+%d)\n",
    LvAttackLife = "附加基础生命%.1f%%(+%d)\n",
    HaveStarFashion = "拥有%d星级时装",
    PutOn = "穿上",
    TryOn = "试穿",
    TryOnDesc = "试穿时装没有属性加成",
    MaterialNotEnough = "材料不足（强化石和陨铁可以通过圣器试炼获得）",
    AttachTotal = "已获得时装附加的总属性",
    UpLimit = "提升上限",
    BuyCondition = "购买条件",
    HourMin = "%d小时%d分后过期",
    FashionAttachAttr = "附加属性",
    FashionChipDiamond = "(     %d可补足)",
    FashionEquipOn = "已穿戴",
    FashionHave = "已拥有",
    FashionBuyed = "已购买",
    FashionPrice = "购买价格",
    FashionChip = "碎片",
    FashionChipBox = "是否消耗蓝钻补足购买时装",
    FashionBox = "是否购买此时装",
    FashionChipDesc = "时装碎片     可在商店中获得",
    FashionLevelDesc = "时装碎片     可在商店中获得(%d级开启)",
    NoBuyCondition = "未达到购买条件",
    ---------------------------日常试炼---------------------
    SceneName = "关卡名称:",
    DailyTrial = "训练场",
    TrialCompelete = "训练完成",
    TimesResetTips = "每日0点重置次数",
    FashionAdvance = "时装 + [e23131]%d[-]%%",
    VIPAdvance = "VIP + [e23131]%d[-]%%",
    YouGet = "你获得 :",
    CDBuy = "清除CD",
    CDBuyMessage = "花费%d蓝钻清除CD?",
    NoTimes = "挑战次数不足（每日0点重置次数）",
    CDIng = "CD中......",
    PlayDes = "玩法说明",
    RemainTimes = "剩余次数",
    SweepTrial = "一键扫荡%s-%s",
    VipAwardTips = "VIP%s奖励+%s%%",
    PlayDesText = "1.活动开启当天,可成功挑战5次\n"..
                  "2.同一关卡,当次挑战胜利后,CD结束后才可进行下次挑战。\n"..
                  "3.\n"..
                  "4.\n"..
                  "5.\n"..
                  "6.",

    -------------arena-----------------------
    SeeDetail = "查看详情",
    Award = "奖励",
    RankAward = "排行奖励",
    NoRankAward = "暂无排名奖励",
    Challenge = "挑战",
    Power = "战力",
    Powering = "[%s]战力:[-]",
    Rank = "[%s]排名:[-]",
    Ranking = "排名",
    NoRank = "暂无排名",
    NextTimeChallenge = "下次挑战",
    CountDownToday = "今日剩余次数",
    CountDownToday2 = "今日剩余次数:",
    YouChallengeSb = "你对[E23131]%s[-]发起挑战,你%s了,",
    SbChallengeYou = "[E23131]%s[-]对你发起挑战,你%s了,",
    RankChangeTo = "%s至第[3894D0]%d[-]名。(%s)",
    SameRank = "排名不变。(%s)",
    NHourAgo = "%d小时前",
    NDayAgo = "%d天前",
    NJustAgo = "刚刚",
    RankToday = "今日排行",
    RankYesterday = "昨日排行",
    RankingList = "排行榜",
    RankUp = "[51BF53]排名提升至%d[-]",
    RankNoChange = "[d53e52]排名不变: %d[-]",
    Role = "角色",
    MoneyAward = "金币奖励",
    ReikiAward = "灵力奖励",
    DiamondAward = "蓝钻奖励",
    Raise = "提升",
    Fall = "下降",
    Succeed = "[51bf53]获胜[-]",
    Fail = "[E23131]失败[-]",
    BuyArenaCount = "购买战神之争次数1次",
    BuyCDTime = "清除倒计时",
    DayCountOut = "今日次数用完了,明日再来吧。",
    VipCanBuyPVP = "VIP%d开放购买竞技场次数",
    BuyUpperLimit = "当日购买次数已达上限",
    VipCanBuyAsrology = "Vip%d才能购买占星次数",
    VipCanBuyPlunder = "Vip%d才能购买挖矿次数",
    UpVip = "提升VIP",
    ArenaCurrentRank = "目前排名:%s",
    TopRank = "最高排名:%d",
    ------------------个人排位赛----------------------
    SeasonTime = "赛季时间：",
    SeasonGrade = "赛季成绩：",
    SuccessSession = "胜场[%s]%d[-]",
    SessionNum = "场次[%s]%d[-]",
    HighWinNum = "最高连胜[%s]%d[-]",
    Regulation = "规则",
    WinningTimes = "连胜场次",
    PatchAwardTimes = "奖励次数：%d  %s",
    MateGamePlayHelp = "[3894D0]活动时间：\n[-]"..
	                    "每周二22:00开始，周三23：59结束\n"..
						"每周四22:00开始，周五23：59结束\n"..
						"每周六22:00开始，周日23：59结束\n\n"..
	                    "[3894D0]挑战关卡：\n[-]"..
                        "1.骑士团成员可在千层塔活动中逐层挑战每层关卡。\n"..
                        "2.每次进入关卡前，勇士可以选择一种属性给自身加成。\n"..
						"3.战前的鼓舞可提高每次选择属性加成的比例。\n\n"..
						"[3894D0]活动奖励：\n[-]"..
						"1.通过每层关卡都会获得金币与推塔币。\n"..
						"2.推塔币可在推塔商店兑换更加珍贵的道具。\n"..
						"3.在通关特定关卡后，还将额外获得符文奖励。\n"..
						"4.每通关10层关卡，还将额外获得符文、灵力等奖励。\n\n"..
						"[3894D0]推塔竞赛：\n[-]"..
						"1.活动开启后，会匹配到一个其他骑士团作为对手\n"..
						"2.开赛时的骑士团成员，将有资格参赛，后加入者无资格。\n"..
						"3.骑士团中每位勇士的最大通关数，将计入骑士团推塔总数。\n"..
						"4.活动结束时，根据竞赛双方推送总数判断胜负。\n"..
						"5.骑士团成员，不同的骑士团职位获得不同奖励。\n",

    ------------------炼金----------------------
    DiamondMoney = "炼金",
    DiamondMoneyDesc = "(有机会暴击获得多倍金币奖励)",
    GainMoney = "获得%d金币",
    ------------------Setting-------------------
    BGM = "背景音乐",
    GameMusic = "游戏音效",
    Mute = "静音",
    HidePlayer = "隐藏玩家",
    Moveoystick="移动摇杆",
    FixedJoystick = "固定摇杆",
    DisPlaySetting = "显示设置",
    Smooth = "流畅",
    Standard = "标准",
    HighQuality = "高品质",

    ------------------奖励类型------------------

    EAwardType_INVALID = "无效", --
    EAwardType_GROUP = "组", --
    EAwardType_EXP = "经验", --
    EAwardType_MONEY = "金币", --
    EAwardType_ITEM = "物品", --
    EAwardType_DIAMOND = "蓝钻", --
    EAwardType_STAMINA = "精力",--
    EAwardType_REIKI = "灵力",--
    EAwardType_TALENT = "天赋",--
    EAwardType_ARMOR = "护甲片",--
    EAwardType_SPAR = "晶石",--
    EAwardType_RED_DIAMOND = "红钻",--
    EAwardType_GANG_EXP = "骑士团经验",
    EAwardType_HOROSCOPE_EXP = "占星经验",
    EAwardType_HONOR = "荣誉",
    EAwardType_Dragon = "屠龙币",
    EAwardType_Medal = "勋章",
    EAwardType_KiloTower = "千层币",
    EAwardType_CallSoulToken = "召魔令",
    EAwardType_SoulBattle = "魔魂试炼次数",
    EAwardType_GhostShopRreshCount = "魔魂商店刷新次数",
    EAwardType_CorpsContribution= "骑士团贡献",
    EAwardType_CorpsGoldcoin = "骑士团金币",
    EAwardType_BeastPoints= "骑士团积分",
    EAwardType_Power = "战力",
    EAwardType_LingeringFragrance = "余香",

    --------btn name---------------
    --Skill = "技能",
    --Equip = "装  备",
    --FairyTitle = "精灵",
    --Hallow = "圣器",
     Ghost = "魔魂",
     PVPandPVAI="竞技场",
     PVPandPVAIRank = "竞技场排名",
     PVPandPVAIUnLock="通关[6febf3]%s[-]",
     PVPandPVAIUnLockTake="接受[6febf3]%s[-]",
     PVPandPVAIUnLockFinish="完成[6febf3]%s[-]",
     PVAI = "战神之争",
     PVP = "荣誉殿堂",
     PvaiDiamond = "  [51BF53](每次最高排名提升将获得蓝钻奖励)[-]",
     MultiPVE = "圣器试炼",
    --ExitGame = "退  出",
    --BackGameHall = "返回主城",
    -- DailyTrial = "训练场",
    -- FashionSys = "时装",
    Divination = "魔魂召唤",
    Reward = "奖励",
    Activity = "",
    FailedDesc = "(选择一个属性加成然后复活)",
    ---------guide--------------------
    OpenNewFunc = "开启新功能",
    GuideTips = "亲，请按照引导指示点击",
    ClickNumTips = "是否关闭当前提示",

    -----------------荣誉殿堂--------------
    PatchStart = "开始匹配",
    PatchCancel = "取消匹配",
    PatchFailed = "匹配失败",
    PatchingTips = "正在匹配对手",
    WaitingTime = "等待时间",
    HonorStore = "荣誉商店",
    HonorActivityRemainTime = "荣誉之战剩余时间",
    KingTowerActivityRemainTime = "本场剩余时间",
    StartTime = "开启时间 : ",
    AwardTimes = "奖励次数 : ",
    Name = "姓名",
    VctoryRate = "胜率",
    ActivityCDTime = "距离活动时间还有",
    ActivityDontOpen = "活动未开启",
    ActivityFinished = "活动已结束",
    HonorActivityDontOpen = "荣誉之战活动20:00开启",
    HonorNoTimes = "奖励次数已用完",
    RefreshKingTowerRankTips = "(每周一0点积分清零)",
    KingTowerDesc = "(角色属性在PK中拉平，保留魔魂和精灵技能效果)",

-----------------聊天--------------
    World = "世界",
    Friend = "好友",
    Group = "房间",
    Notice = "公告",
    CustomService = "客服",
    Team = "组队",
    Send = "发送",
    Voice = "语音",
    Face = "表情",
    Chat = "聊天",
    Show = "展示",
    Delete = "删除",
    SystemNotice = "系统",
    PressToRecord = "按下开始录音",
    ReleaseToSend = "松开发送",
    CheackInfo = "查看信息",

    AddFriend = "加好友",
    ChatPrivate = "私聊",
    NoCorpsTips = "您还未加入骑士团。",
    NoJoinCorpsTips = "未加入骑士团，%d级开启骑士团玩法",
    NoCrops = "[暂无骑士团]",
    OnLine = "在线",
    OffLine = "离线",
    FriendNum = "好友(%d/%d)",
    WorldChat = "[世]",
    CorpsChat = "[团]",
    NoGroupTips = "您还未加入房间",
    InviteFriendPVE = "你成功邀请好友{%s}加入你的房间。",
--------------------PVEMore Begin-------------------------------
--------------createRoompanel------
    RoomPassword="房间密码:",
    QuickSearch="奖励倍数:",
    AwardMulti="倍数",
    EveryConsumeLbl="本轮消耗:",
    SetPassword="设置密码",
    DropText="可能掉落:",
    QuickSearchTitle="修改奖励",
    EveryConsumeTip="(每轮8关)",
    DailyFreeAwardTimes="今日剩余圣器试炼钥匙数量",
    MultipleTimeTips = "%d倍以上挑战将自动分解紫色以下品质圣器",
    VipCanPlusTimesTips = "VIP%d可以开启%d倍挑战",
    Commission = "佣金",
    FinishedEmploy = "已雇佣",
-----------------------------------
    MyRoom = "我的房间",
    RoomList = "房间列表",
    CreateRoom = "创建房间",
    AutoJoin = "自动加入",
    Join = "加入",
    Challenging = "挑战中",
    Modify = "修改",
    RoomOwner = "房主",
    RoomMember = "成员",
    NoMemberToInvite = "没有成员,点击邀请",
    InviteMember = "可雇佣自己骑士团成员参展",
    InviteFriend = "好友邀请",
    WorldInvite = "世界邀请",
    Invite = "邀请",
    QuickTimes="[D4E4EE]%d倍[-]",
    InputPrompt = "4位数字",
	Room = "房间号",
    Difficult = "困难",
    Nightmare = "噩梦",
    CreateRoomFirst = "您暂时没有房间。",
    StartChallenge = "开始挑战",
    LeaveRoom = "离开房间",
    Ready = "准   备",
    CancleReady = "取消准备",
    FightPower = "战斗力",
    NeedPassword = "需要密码",
    InputPassword = "输入密码",
    PlaseInputPass = "请输入密码",
    QuitPveMoreUITips = "关闭后将解散房间",
    PleaseUpVip = "请提升VIP等级",
    PleaseUpVipDetial = "需要达到VIP%d",
    PVEMoreNextSceneBtnTips = "等待房主选择下一关",
    PVEMoreLV="%d级",
    InviteBtn = "雇佣",
    InviteFriendContent = "{圣器试炼-房间%s}【%s】一起来挑战吧!",
    InviteKingTowerContent = "{王者之塔-房间%d}一起来挑战吧!",
    WorldInviteContent = "来个高手同刷！",
    InviteBaseContent = "{圣器试炼-房间%s}【%s】%s",
    KictMember = "踢人",
    ChangeHost = "转让房主",
    ChangeHostTips = "接受邀请，成为房主！",
    PVEMoreSystemTips = "圣器试炼系统未开启！",

---------------------PVEMore end----------------------------------------------
----------------------PVPandPVAI start ---------------------------------------------
    ShutOffTip="功能暂未开启",
----------------------PVPandPVAI end ---------------------------------------------
    PleaseClickMagicBook = "请点击魔法书",
    WipeProducing = "书写中… ",
    WipeStopped = "暂停书写",
    WipeStoppedForFull = "已达上限，停止书写",
    NoWipeToCollection = "目前无可收取的扫荡卷，请耐心等待",
    -- WipeWaitingCollected = "[51BF53]x%d[-]",
    GoToBattle = "前往副本",
    Scroll = "卷轴",
    PrimaryMagic = "初级扫荡",
    MidMagic = "中级扫荡",
    SeniorMagic = "高级扫荡",
    MagicScroll = "扫荡卷",
    WipeInventory = "剩余  %d/%d",

    FreeChanllengeTimes = "免费挑战次数",
    NextScene = "下一关",
    FreeReliveTimes = "免费复活次数",
    FreeRelive = "免费复活",

    InputRoomID="输入房间号",

    MagicBook="魔法屋",

    UseErrorSpeedMachine = "使用了不合法的加速器",
    --------------------------------------骑士团 Corps Start-----------------------------
    --------Corps GameHall
    HidePersonUI="隐藏人群",
    Corps="骑士团",
    AstrologyBtnName="占星",
    BeastStoreBtnName = "驯兽商店",
    ------骑士团基础管理---
    ManagerBtnName = "团员管理",
    CorpsColonel="团长",
    CorpsLevel="骑士团等级",
    CorpsPersonNum="人数",
    CorpsApply="申请",
    CorpsLook="查看",
    CorpsApplying ="申请中",
    CancelApply="是否取消申请？",
    CorpsCreate="创建骑士团",
    CorpsQuickAdd="快速加入",
    CorpsCreateTips="达到VIP1级才能创建骑士团",
    CorpsCreateBtn="创建",
    CorpsInputName="名称",
    CorpsCreateCost="消耗",
    CorpsLookTitle="骑士团查看",
    CorpsLookRole="角色",
    CorpsLookLevel="等级",
    CorpsLookOccupy="职位",
    CorpsLookFight="战力",
    CorpsLookRank="排名",
    CorpsLookExp="经验",
    CorpsCellNum = "层数",
    CorpsIntroduce="骑士团介绍:",
    CorpsApplyTitle="【%s】骑士团招募条件",
    ColonelDetail="查看详情",
    ColonelFlower="送鲜花",
    ColonelEgg="砸鸡蛋",
    ColonelFriend="加好友",
    ColonelBackFriend="黑名单",
    CorpsNameTips="骑士团名称(最多4个汉字)",
    SearchCorpsBtn="搜索",
    SearchCorpsInput="输入骑士团名称...",
    CorpsInfo="骑士团信息",
    CorpsApplyFight="最低战力",
    CorpsInspireVipNeed = "达到VIP%d才能进行鼓舞",
    CorpsBtnsOpenTips = "角色%d级，骑士团%d级开启",
    CorpsApplyReplyTips = "申请加入了骑士团，等待团长审批通过",
    ------我的骑士团
    GotoCorpsBtnName="进入骑士团",
    MyCorpsTitle="我的骑士团",
    CorpsDesc="骑士团宣言",
    WeekCorpsExp="本周骑士团经验",
    MyCorpsIntroEdit="编辑",
    ExitCorps="退出骑士团",
    DissolveCorps="解散骑士团",
    ColonelExit="您确定解散骑士团吗？",
    MemberExit="您确定退出骑士团吗？",
    Member="成员",
    Log="日志",
    --------成员管理
    MemberCtrUI="成员管理",
    MemberListBtn="成员列表",
    ApplyListBtn="申请列表",
    LastLogin="最近登录",
    Duty="职务",
    SetRecruit="设置招募",
    PublishRecruit="发布招募",
    RecruitCondition="[3894D0]招募条件[-]\n战力要求:%d[51bf53](%s自动加入)[-]",
    Allow="允许",
    NoAllow="不允许",
    SetFight="设置战力",
    AllowAutoJoin="允许自动加入骑士团",
    ExpelTips="您确定将%s驱逐出骑士团吗？",
    TransferTips="您确定将团长转让给%s吗？",
    ApplyTime="申请时间",
    ApplyCheck="审核",
    OneNoAgree="一键拒绝",
    OneAgree="一键通过",
    NoAgree="拒绝",
    Agree="通过",
    ApplyTimeStick="%d年%d月%d日",
    ApplyTimeStickDetail = "%d年%d月%d日 %s:%s:%s",
    OnLineTips="在线",
    --------骑士团排行榜
    CorpsRankTitle="骑士团排行榜",
    FightRankBtn="战力榜",
    CorpsRankBtn="骑士团榜",
    FlowerRankBtn="鲜花榜",
    BeautyRankBtn="美女榜",
    CorpsLogTitle="骑士团日志",
    CorpsLogContent="骑士团动态",
    CorpsLogTime="时间",
    EditerCorpsText = "点击编辑骑士团宣言",
    PleaseInputText = "请编辑骑士团宣言",
    --------千层塔
    NoticeKiloTower = "千层塔开启，快来推塔。",
    NoticeKiloTowerLink = "前往推塔",
    KiloTowerBtnName="千层塔",
    OurProgress="我方进度",
    EnemyProgress="敌方进度",
    EmbraveRecord = "鼓舞记录",
    CurBuffer = "当前加成",
    NextBuffer = "下级加成",
    LastRank = "上届排名",
    CorpsProgress = "推塔进度",
    CorpsEmbrave = "鼓舞",
    Floor = "层",
    Day = "天",
    Hour = "小时",
    Minute = "分钟",
    Second = "秒",
    RemainTime = "活动剩余时间:",
    SceneRemainTime = "关卡剩余时间:",
    NextOpenTime = "下次开启时间:",
    NoActivity = "活动未开启",
    RankInCorps = "骑士团内排名:",
    CurSingleNum = "个人当前层数",
    PushTowerAttrAddTips = "骑士团成员推塔时可选择一种属性加成",
    CurPushHardParam = "千层塔初始难度等级:",
    BuyAttrAdd = "购买属性加成",
    TheFloorNum = "第%d层",
    SelEmbraveTips = "请选择一项属性加成",
    DaysAgo = "%d天前",
    HoursAgo = "%d小时前",
    MinutesAgo = "%d分钟前",
    PushProgress = "推塔进度%s层",
    EmbraveHistory = "【%s】花费%d钻石鼓舞,鼓舞等级升到了%d级(%s)",
    AttrAddTip = "选择一种属性加成开始挑战(鼓励等级Lv.%d)",
    CommanderReward = "团长奖励:",
    ViceReward = "副团长奖励:",
    ForwardReward = "前锋奖励:",
    CenterForwardReward = "中锋奖励:",
    MemberReward = "团员奖励:",
    KiloTowerShop = "推塔商店",
    IsMaxLevel = "已达最大等级",
    BoxCanNotOpen = "宝箱不满足开启条件",
    CorpsLimit = "骑士团等级达到%d级开启千层塔活动",
    RoleLimit = "个人等级达到%d级才能参加千层塔活动",
    CanNotJoinTips = "你没有资格参加本期活动",
    StartToPushTower = "开始推塔",
    keepAhead = "领先",
    FallBehind = "落后",
    KiloWin = "胜利",
    KiloFail = "失败",
    IsEmpty = "轮空",
    KiloTowerPlayHelp = "[3894D0]活动时间：\n[-]"..
	                    "每周二22:00开始，周三23：59结束\n"..
						"每周四22:00开始，周五23：59结束\n"..
						"每周六22:00开始，周日23：59结束\n\n"..
	                    "[3894D0]挑战关卡：\n[-]"..
                        "1.骑士团成员可在千层塔活动中逐层挑战每层关卡。\n"..
                        "2.每次进入关卡前，勇士可以选择一种属性给自身加成。\n"..
						"3.战前的鼓舞可提高每次选择属性加成的比例。\n\n"..
						"[3894D0]活动奖励：\n[-]"..
						"1.通过每层关卡都会获得金币与推塔币。\n"..
						"2.推塔币可在推塔商店兑换更加珍贵的道具。\n"..
						"3.在通关特定关卡后，还将额外获得符文奖励。\n"..
						"4.每通关10层关卡，还将额外获得符文、灵力等奖励。\n\n"..
						"[3894D0]推塔竞赛：\n[-]"..
						"1.活动开启后，会匹配到一个其他骑士团作为对手\n"..
						"2.开赛时的骑士团成员，将有资格参赛，后加入者无资格。\n"..
						"3.骑士团中每位勇士的最大通关数，将计入骑士团推塔总数。\n"..
						"4.活动结束时，根据竞赛双方推送总数判断胜负。\n"..
						"5.骑士团成员，不同的骑士团职位获得不同奖励。\n",

    --------tips
    Appoint="任命",
    Transfer="转让团长",
    Expel="驱逐",
    MemberAppoint="成员任命",
    FuColonel="副团长",
    QianFeng="前锋",
    ZhongFeng="中锋",
    TuanYuan="团员",
    AlreadyMaxLv ="已达最大等级" ,
    ----Log
    JoinCorpsLog = "[f7c45d]%s[-]加入了骑士团",
    QuitCorpsLog = "[f7c45d]%s[-]退出了骑士团",
    KictCorpsLog = "[f7c45d]%s[-]被驱逐出了骑士团，大家引以为戒！",
    SetPositionLog = "[f7c45d]%s[-]由[f7c45d]%s[-]职位被任命为[f7c45d]%s[-]职位",
    PublishRecruitContent="【%s】骑士团招人，共享天下！(要求战力：%d)",
    MinuteAgo = "%d分钟前",
    HoursAgo = "%d小时%d分钟前",

    ------------占星-------------------
    AstrologyTitle="骑士团占星",
    BestRecord="本周最佳纪录",
    StargazerLevel="占星师等级",
    AstrologyValue="占星值",
    AstrologyWakan="占星灵力",
    AstrologyNum="占星名额",
    DailyTimes = "今日次数",
    AstrologyBtn="占星",
    AstrologyRank="占星排名",
    TreasureBtn="宝箱",
    AstrologyIntroduction="活动声明",
    AstrologyIntroContent = "[3894D0]活动时间：\n[-]"..
	                    "每日全天\n\n"..
	                    "[3894D0]占星玩法：\n[-]"..
                        "1.点击占星可以随机获得一种占星卡片。\n"..
						"2.占星结果会从8张卡片中随机挑选一张。\n"..
						"3.占星所得卡片等级越高，玩家获取的占星奖励越丰厚。\n"..
                        "4.每天有5次免费占星次数，增长至上限则不再增长。\n"..
                        "5.VIP4以上玩家可消耗蓝钻购买占星次数。\n\n"..
						"[3894D0]活动奖励：\n[-]"..
						"1.占星可以获得大量灵力，还有机会获得橙色装备。\n"..
						"2.玩家占星可以增加该骑士团占星师的占星值。\n"..
						"3.占星值达到特数量后，占星师的等级会得到提升。\n"..
						"4.占星师升级后，每次占星所得的灵力数量会相应增加。\n\n"..
						"[3894D0]占星奖励由低至高依次为：\n[-]"..
						"占星结果为[51bf53]星辰[-]奖励灵力\n"..
						"占星结果为[51bf53]月亮[-]奖励灵力\n"..
						"占星结果为[2283c3]太阳[-]奖励大量灵力\n"..
						"占星结果为[2283c3]小丑[-]奖励大量灵力\n"..
						"占星结果为[8758d7]恋人[-]奖励大量灵力同时将有机会获得橙装\n"..
						"占星结果为[8758d7]祭司[-]奖励大量灵力同时将有机会获得橙装\n"..
						"占星结果为[D7752D]王后[-]奖励大量灵力同时将有机会获得橙装\n"..
						"占星结果为[D7752D]国王[-]奖励大量灵力同时将有机会获得橙装\n",
    AstrologyTips="提示",
    BuyAstroTimesTips1="是否购买1次占星次数",
    GetRewardSuccess="成功获得奖励",
    OneKeyBuy="一键购买",
    AstroReward="占星奖励",
    CorpsExp="骑士团经验 + %d",
    AstroExp="占星值",
    RollPoint="点数",
    MyRollPoint="我的点数:",
    AstrologyReKei = "灵力",
    AstrologyLevelFull="占星等级已满！",
    ----------------------挖矿 Mine-------------
    MineBtnName = "挖矿",
    MineTitle="骑士团挖矿",
    WhoMine="【%s】的骑士团矿洞",
    MineLevel="[3894D0]矿洞等级[-]",
    MineLeveFoDetail="矿洞等级",
    CorpsExpSimp = "骑士团经验",
    MineExp="矿洞经验",
    RewardBonus="灵力与宝石精华奖励加成",
    MinePerson="挖矿名额",
    RobTimes="[3894D0]掠夺次数[-]: [51bf53]%d[-]/%d",
    MineRob="前往掠夺",
    MineDetail="详情",
    MineTimes="挖矿次数：[51bf53]%d[-]/%d",
    MineStartBtn="开始挖矿",
    MineIntroBtn="玩法介绍",
    MineLogBtnName="掠夺记录",
    BuyRobTimesTs="购买一次掠夺次数？",
    MineLevelFull = "矿洞等级已满！",
    --begin
    MineGem = "宝石精华",
    DiamondFight="宝石提供的战力值:%d",
    MiningTime="挖矿时间:%d分/次",
    MiningAward="挖矿收益",
    RobbingAward="掠夺收益",
    RemainMiningTs="剩余挖矿次数：%d/%d",
    RemainMineTimesTs="剩余次数：%d次",
    NextAward="下次收获：%s",
    MiningEnd="挖矿结束",
    MiningEndTips="点击宝箱，领取奖励",
    MiningCDTips="立即完成本次挖矿？",
    NOthisMine = "无此矿洞！",
    ---rob
    Leave ="离开",
    GoToRobTitle="前往掠夺",
    GoToRobBtnName="掠夺",
    RobCorpsRank="骑士团排名",
    RobCorpsName="骑士团名称",
    BackMyCorpsBtn="返回本骑士团",

    MinePlayHelp = "[3894D0]活动时间：\n[-]"..
	                    "每日全天\n\n"..
	                    "[3894D0]挖掘矿洞：\n[-]"..
                        "1.进入骑士团矿洞可点击开始挖矿。\n"..
                        "2.挖矿需等待2个小时或使用蓝钻消除时间才可获得奖励。\n"..
						"3.每日5次挖矿次数，每日凌晨0点会刷新这个次数。\n\n"..
						"[3894D0]活动奖励：\n[-]"..
						"1.每次挖矿均可以获得宝石、灵力以及若干宝箱。\n"..
						"2.宝箱有几率开出蓝钻、装备、宝石等稀有道具。\n"..
						"3.矿洞等级、角色等级将影响获得宝石与灵力。\n"..
						"4.角色等级将影响获得的宝箱数量，最多每次10个。\n\n"..
						"[3894D0]掠夺矿洞：\n[-]"..
						"1.勇士可以在其他骑士团矿洞掠夺对方正在挖矿的成员。\n"..
						"2.每日5次掠夺次数，次数用尽，可以消耗蓝钻购买。\n"..
						"3.掠夺成功将会获得灵力、宝石以及被掠夺者一个宝箱。\n"..
						"4.同时，还会增加掠夺者骑士团经验与矿洞经验。\n",


    AutoSellEquip="自动出售以下品质的装备:",
    OneKeyOpen="一键开启",
    MineAwardTitle="挖矿奖励",
    AwardPlus=" + %d",
    MineLevelAddPer="骑士团矿洞等级加成%s",
    BeRobbed="被掠夺",
    RobberTitle="挖矿过程中受到[d53e52]【%s】%s[-]的掠夺",
    CorpsAndPosition ="【%s】成员",
    MineRecords = "掠夺记录",
    RobberTip = "掠夺者",
    MineLoseTip = "损失",
    MineTimeTip = "时间",
    MyMineRobRecoredTip = "我的日志",
    CopsMineRobRecoredTip = "骑士团日志",
    MineHateCorps = "仇恨骑士团",
    MineRobTimes = "掠夺次数",
    MineFightBack = "反击",
    MineOpenTips = "矿洞暂未开启",

    ----BeastTrain
    BeastTrainName = "驯兽场",
    BeastTrainTimes = "驯兽次数",
    BeastTrainNum = "驯兽名额",
    BeastTrainProgress = "驯兽总进度",
    BeastFinish = "[e3d08e]已驯服[-]",
    BeastTip = "选择一个驯兽部分，即可进入驯兽",
    NextBeastBossTip = "通关后军团等级%d级开启%s",
    BeastYesterdayProgress = "昨日进度",
    BeastTimesExchange = "驯兽兑换",
    BeastHead = "兽头",
    BeastHand = "兽手",
    BeastTimesCash = "boss被驯服后才可兑换",
    BeastTimesNotEnoughCash = "驯兽次数不足不能兑换",
    BeastHelpInfo = "[3894D0]活动时间：\n[-]"..
	                    "每日全天\n\n"..
	                    "[3894D0]基础规则：\n[-]"..
                        "1.集合骑士团所有成员的力量驯服怪物。\n"..
                        "2.每天有2次驯兽机会，也可以花费钻石购买驯兽次数。\n"..
						"3.每个BOSS被分为四个关卡，点击关卡开始驯服。\n"..
						"4.战斗前可以消耗钻石进行鼓舞，鼓舞可以增加角色属性。\n"..
						"5.每天0点奖励结算，根据击杀BOSS的进度发放奖励。\n\n"..
						"[3894D0]多彩宝石奖励：\n[-]"..
						"1.击杀BOSS将解锁军需官处多彩宝石开孔符的兑换。\n"..
						"2.多彩宝石的等级与开孔，随着击杀BOSS的数量而提升。\n"..
						"3.团长与副团可在军需官处花费骑士团金币购买开孔符。\n"..
						"4.骑士团财富可以通过进度奖励与通关奖励获得。\n"..
						"5.开孔符购买后出现在战利品仓库中，通过花费贡献获得。\n\n"..
						"[3894D0]活动奖励：\n[-]"..
						"1.每次参与战斗，都会获得经验、金币以及骑士团贡献。\n"..
						"2.驯兽各关卡进度越高，骑士团会获得越多的进度奖励。\n"..
						"3.关卡全部通过，可获得关卡驯服奖励及BOSS驯服奖励。\n"..
						"4.若驯兽BOSS今日已被驯服，玩家仍有驯兽次数可以通过驯兽兑换直接获取战斗奖励。\n\n"..
						"[3894D0]骑士团商店：\n[-]"..
						"1.玩家可以在驯兽商店使用骑士团贡献直接兑换道具。\n"..
						"2.每日骑士团获得的驯兽奖励，会出现在战利品仓库中。\n"..
						"3.骑士团成员可以在战利品仓库，花费贡献申请道具。\n"..
						"4.骑士团团长与副团长不需要申请，可以直接兑换。其他成员需要审批。\n",

    PartUITrain = "驯服度:",
    PartUIWay = "作战方式:",
    PartUINeed = "作战需求:",
    PartUICondition = "参与条件:",
    PartUIInspire = "鼓舞加成:",
    PartUIPersonal = "个人鼓舞:",
    PartUILogBtn = "驯兽日志",
    PartUIStartBtn = "开始驯兽",
    PartUIInspireStr = "攻击+%s  防御+%s  生命+%s",

    BeastQuotaTitle = "骑士团驯兽",
    BeastQuotaNotification = "通知",
    BeastQuotaNotificationBtn ="通知他",
    BeastQuotaTip = "今日未驯兽人数：%d",
    BeastQuotaNotificationTip = "今天还没有驯兽哦,快来驯兽吧",

    TrainLogProgress = "进度",
    TrainLogTimes = "驯服次数 %d",

    YesterdayAllTrain = "总计驯兽",
    YesFinishTimes = "已完成次数",
    YesNoTrain = "未驯兽",
    YesTimes = "%d次",

    BAwardTrain = "驯服奖励",
    BAwardProgress = "进度奖励",

    BuyBeastTimes = "确定购买挑战次数",
    ExchangeBeastTimesTip = "BOSS已被驯服，是否直接消耗驯服次数兑换奖励",
    NotEnoughCorpsGoldcoin = "骑士团币不足",
    BeastDiamondTip = "蓝钻不足",

    ----beastStore
    BStoreSpoils = "驯兽战利品",
    BStore = "驯兽商店",
    SpoilsYesterdy = "昨日战利品",
    SpoilsHouse = "战利品仓库",
    ProgressStore = "驯兽进度商店",
    WareHouse = "仓库(%d/%d)",
    DistributeLog = "分配日志",
    DataTitle_thing = "物品",
    DataTitle_Price = "物价",
    DataTitle_personnum = "申请人数",
    DataTitle_applyState = "申请状态",
    BStoreUnLockTips = "解锁条件:成功驯服【%s】",

    BStoreNeedPerson = "骑士团还有%d人需要",

    BApplyCheck = "审核中",
    BApplyAgree = "已通过",
    BApplyNoAgree = "未通过",
    BNoApply = "取消申请",
    BGainReward = "领取道具",

    BOwer = "获得者",
    OwerTime = "获得时间",

    TimesBuySuc = "道具购买成功",
    ApplyExpSuc = "申请道具成功",
    ApplyExBtn = "申请兑换",
    ApplyExpConfirm = "是否兑换该道具",

    BeastTrainOpenTip = "驯兽场开启条件：角色等级:%d  骑士团等级:%d",

    BApplyerListTitle = "申请者列表",
    BApplyerListNum = "申请人数[51bf53]%d[-]人",
    BApplyerListGiver = "【%s】分配",

    BRemainNum = "剩余数量%d",
    BPersonal = "个人",

    ----Navigation航海
    NavigationName = "出海寻宝",
    ToSeaHunt = "出海寻宝",
    AwardRecord = "奖励记录",
    AwardAllNum = "奖励总数",
    TodayAward = "今日获得",
    NavigationCount = "次数",
    NavigationCountInfo = "寻宝行动力: %d/%d",
    DayNavigationCount = "今日寻宝次数：%d/%d",
    DayBuyNavigationCount = "今日购买次数：%d/%d",
    TodayNavigationCount = "今日寻宝%d次",
    AutoNavigation = "自动寻宝",
    CancelNavigation = "取消自动",
    NotEnoughNavigationCount = "行动力不足，请先购买行动力",
    HowNum = " x%d",
    NavigationConsume = "获得1000金币\n并获得一次航行次数",
    BuyNavigationCount = "购买1000金币并赠送1次行动力",
    AwardDes = "%s X%d",
    MatterAwardDes = "探索发现大量宝藏\n快到军团驻地内领取",
    DoubleAwardDes = "众神赐福，下次奖励翻倍",
    FreeAwardDes = "发现补给品，本轮无消耗",
    CorpsMatter = "军团宝藏",
    GetCorpsMatterDes = "宝藏记录",
    MysticaAwardInfo = "看手气",
    NavigationTreasure = "航海宝藏",
    Discover = "发现者",
    Surplus = "剩余数量",
    AwardState = "状态",
    FoundMatterAward = "我在航行中发现大量宝藏，快来军团驻地",
    GetMatterAward = "我领取了%s发现的宝藏,获得了%s,你们也来试试手气啊",
    FinishedMatterAward = "该宝藏已被一抢而空",

    OpenConditionVip = "需要VIP等级达到%d开启",
    OpenConditionCorpsLv = "军团等级需要达到：%d级",
    OpenConditionRoleLv = "角色等级需要达到%d开启",
    OpenNavigationCondition = "角色%d级,VIP%d以上开启",
    StartNavigationTips = "点击骰子开始寻宝",

	NavigationPlayHelp = "[3894D0]参与条件与时间：\n[-]"..
	                    "VIP6级可参与，活动时间为全天\n\n"..
	                   	"[3894D0]活动玩法：\n[-]"..
						"1.点击骰子开始出海寻宝，骰子点数为航行步数。\n"..
						"2.寻宝途中会获得各类珍宝或遇到各类事件。\n"..
						"3.VIP6以上玩家每天会获得寻宝行动力。\n"..
                        "4.行动力最多叠加至行动力上限，请尽快使用。\n\n"..
						"[3894D0]宝藏事件：\n[-]"..
						"1.寻宝途中有几率发现大量宝藏。\n"..
						"2.宝藏置于骑士团场景内，其他成员可以领取。\n"..
						"3.成员只能领取一次同一宝藏，数量有限，先到先得。\n"..
						"4.宝藏被发现后，将存在4个小时，时间结束后宝藏消失。\n\n"..
						"[3894D0]自动寻宝：\n[-]"..
						"1.自动寻宝可以帮助玩家自动进行寻宝活动。\n",

    -------------------------------GVG------------------------
    PeopleInBattle = "出席成员",
    BattleInfo = "战报",
    --------------------------------------骑士团 Corps end-------------------------------
    -------------------------------------屠龙战纪--------------------------------------
    DragonWar = "屠龙战纪",
    HidePlayers = "隐藏",
    ActivePlayers = "显示",
    DragonHall = "屠龙殿堂",
    DragonShop = "屠龙商店",
    Inspire = "鼓舞",
    DragonInspireNoStartMsg = "活动开启前1分钟开启",
    Guess = "竞猜",
    DragonGuessNoStartMsg = "活动开启前10分钟开启",
    RankFirst = "第一名",
    RankSecond = "第二名",
    RankThird = "第三名",
    DragonKillerSum = "累计屠龙者天数:",
    DragonKillDays = "屠龙者天数",

    SingleAttr = "个人%s+%d%%",
    SingleAttrAdvance = "个人%s加成",
    CropsAttr = "骑士团成员%s+%d%%",
    CropsAttrAdvance = "骑士团%s加成",
    IsNotCropsLeader = "您不是团长",
    AttrHasAdv = "已加成过啦",

    SupportSomeBody = "支持他",
    SupportPass = "已支持",
    DragonGuessAFMsg = "竞猜结束倒计时",
    DragonGuess = "屠龙竞猜",
    DragonSupportAwardMsg = "支持方获得今日排名第一，你可获得%d金币",
    DragonSupporterNum = "支持者",
    DragonHasNoKiller = "当前还未有屠龙者",
    DragonKiller = "屠龙者",

    GragonBattleEnd = "战斗结束",
    GragonBattleMsg = "本轮供造成伤害",
    GragonKillBoss = "击杀Boss",
    TotalDamage = "总伤害",
    GotoKingCity = "请先前往王城",
    CurrentRank = "今日排名",
    AllRank = "总排名",
    DragonRank = "屠龙榜",
    MyRank = "我的排名:",
    DamageRank = "伤害排名:",
    MyDamage = "我的伤害:",

    DragonNoDamage = "今日无伤害",
    DragonNoRank = "今日无排名",
    ReliveRightNow = "立即复活",
    DragonActivityStartMsg = "距活动开启:",
    DragonActivityEndMsg = "距活动结束:",
    DailyReward = "日常奖励",
    GetReward = "领取奖励",
    Close = "关闭",
    DailyRewardNo = "没有奖励啦>_<",
    NoPassScene = "未通过",
    HasGain = "已领取",


    DragonWarPlayHelp = "[3894D0]活动时间：\n[-]"..
	                    "每日20:00---20:05\n\n"..
	                    "[3894D0]击杀BOSS：\n[-]"..
                        "1.活动期间进入，点击巨龙肖克斯进入战斗。\n"..
                        "2.在限定时间内，请尽力对BOSS造成更多伤害。\n"..
						"3.BOSS会释放技能对你造成伤害，所以请做好战前准备。\n"..
						"4.活动时间结束，无论巨龙是否被击杀，活动都将结束。\n"..
						"5.如果巨龙被击杀，之后遇到的巨龙将更加强大。\n"..
						"6.如果未能击杀巨龙，那么明日你将继续挑战它。\n\n"..
						"[3894D0]活动奖励：\n[-]"..
						"1.活动结束后，根据参与者对BOSS造成的伤害产生排名。\n"..
						"2.排名越靠前，可获得的屠龙奖励就越丰厚。\n"..
						"3.奖励内容包括：金币、经验、灵力。\n\n"..
						"[3894D0]屠龙者称号：\n[-]"..
						"1.每次活动结束，累计伤害最高的玩家获得屠龙者称号。\n"..
						"2.屠龙者诞生后，在屠龙场景内会为他树立屠龙雕像。\n"..
						"3.成为屠龙者的勇士，每天可前往自己的雕像处领取丰厚奖励，直到屠龙者的身份被替代。\n\n"..
						"[3894D0]战前鼓舞：\n[-]"..
						"1.鼓舞可以大幅增加人物在此活动中的攻击属性。\n"..
						"2.活动开始前1分钟，可以对你或骑士团成员进行鼓舞。\n\n"..
						"[3894D0]屠龙竞猜：\n[-]"..
						"1.活动开启前10分钟，你可以选择一位玩家进行支持。\n"..
						"2.被选名单为上期活动中对BOSS伤害排名前3位的玩家。\n"..
						"3.如果你支持的勇士，本次排名第一，你将获得丰厚奖励\n",

    ------------------守卫皇城-征讨--------------------
    CastleDefend = "守卫皇城",
    CastleDefendShop = "守卫商店",
    CastleDefendHelp = "玩法介绍",
    CastleDefendScoreRank = "积分榜",
    CastleDefendCallEnemy = "洞悉敌军",
    CastleDefendHelpDesc = "[3894D0]活动时间：\n[-]"..
	                    "每日全天\n\n"..
	                    "[3894D0]击退敌军：\n[-]"..
                        "1.黑曜军团的成员不断入侵主城。\n"..
                        "2.点击你要剿灭的敌军进入战斗，在身死之前干掉他们。\n"..
						"3.敌人有不同等级和品阶，请选择一场你有把握的战斗。\n\n"..
						"[3894D0]黑曜首领：\n[-]"..
						"1.场景内有几率同时出现5个黑曜首领，但只有一个真身。\n"..
						"2.找到首领真身并击杀他，你将获得更加丰厚的奖励。\n"..
						"3.VIP3级以上的玩家可花费蓝钻使用洞悉敌军功能。\n"..
						"4.洞悉敌军会使场景内出现黑曜首领，同时玩家将获得灵力和精力返利。\n\n"..
						"[3894D0]活动奖励：\n[-]"..
						"1.每天的前10次战斗胜利，玩家还将获得角色经验奖励。\n"..
						"2.每日0点，系统将重置玩家可获得经验的挑战次数。\n"..
						"3.每场战斗胜利玩家都将获得丰厚奖励，包括金币、蓝钻和装备等\n\n"..
						"[3894D0]积分榜：\n[-]"..
						"1.骑士团成员在击杀入侵敌人后将获得守卫积分。\n"..
						"2.被击败的敌军等级、品阶越高，获得的积分越高。\n"..
						"3.积分排名前20名的骑士团成员，都将获得金币奖励。\n"..
						"4.骑士团内贡献前3名的勇士，可获得额外金币奖励。\n\n"..
						"[3894D0]积分规则：\n[-]"..
						"击杀黑曜小兵将获得10点积分。\n"..
						"击杀黑曜精英将获得14点积分。\n"..
						"击杀黑曜前锋将获得18点积分。\n"..
						"击杀黑曜密探将获得40点积分。\n"..
						"击杀黑曜首领假身将获得22点积分。\n"..
						"击杀黑曜首领真身将获得88点积分。\n",


    CastleDefendActiveNotOpen = "活动未开启",
    CastleDefendNpcBusy = "我正在忙着呢没空理你",
    CastleDefendRankNow = "本次排名",
    CastleDefendRankLast = "上次排名",
    CatsleDefendScore = "守卫积分",
    CastleDefendAward = "奖励(每人)",
    CastleDefendRoleName = "角色名称",
    CastleDefendRoleScore = "贡献积分",
    CastleDefendLastTime = "最近贡献",
    CastleDefendRankAward = "排名奖",
    CastleDefendRoleRankTitle = "【%s】的成员贡献",
    CastleDefendCallTips = "召唤出一波黑耀骑士团首领",
    CastleDefendCallPlusTips = "召唤出一波黑耀骑士团首领\n本次洞悉免费",
    CastleDefendCountDown = "结算倒计时: %s",
    CastleDefendHourBefore = "%d小时前",
    CastleDefendMinuteBefore = "%d分钟前",
    CastleDefendDayBefore = "%d天前",

    CastleDefendIntegral = "皇城积分",
    SceneIntegral = "积分",
    CastleDefendCounter = "可获得经验次数：%d/%d",
    CastleDefendCounterTips = "点击怪物战斗",
    ---------------------------入围赛-------------------------------------
    CorpsSelectedIntegral = "入围赛积分",
    PersonalRank = "个人排名：",
    CorpsRank = "军团排名：",
    CorpsSelectedNotice = " [f7c45d]幽灵军团[-]正在大举进攻你的 [f7c45d]骑士团领地[-]，各位尽快返回领地进行剿灭",
    PersonalRankLbl = "个人排名",
    CorpsRankLbl = "军团排名",
    ActiveIntergral = "活动积分",
    IsEntrance = "是否入围",
    Entrance = "入围",
    NotEntrance = "未入围",
    CorpsGVGMatches = "骑士团联赛",
    ContributionIntergral = "贡献积分",
    CorpsContribution = "【%s】的成员贡献",
    FightCorpsNPCTips = "角色到达%d可参加军团入围赛",

    ---------------------------王者之路-------------------------------------
    KingRoad = "王者之路",
    KingRoadElite = "精英王者之路",
    TreasureBox = "宝箱",
    YesterdayPassTimes = "昨日通关普通关次数:",
    YesterdayElitePassTimes = "昨日通关精英关次数:",
    LastTimeLevel = "上一次挑战关卡",
    KingRoadAwardTip = "奖励大量金币，宝石精华，橙色装备和圣器，怪物等级越高奖励越丰厚",
    KingRoadSystemTips = "王者之路系统未开启！",

    ---------------------------------------好友------------------------------------------
    GameFriend = "游戏好友",
    CorpsFriend = "骑士团成员",
    LookFlower = "查看鲜花",
    AddFriends = "添加好友",
    SendSFlower = "送花",
    SendFlowerSuccess = "赠送成功,已不能获得额外奖励",
    FlowerNoCost = "VIP6免费一次",
    GetSinew = "领精力",
    SendSinew = "送精力",
    AttackPower = "战斗力",
    FastGet = "一键领取",
    FastSend = "一键赠送",
    GainSinewMsg = "今日可领取精力",
    Add = "添加",
    AddSuccess = "添加成功",
    DeleteSuccess = "删除成功",
    HasBeenFriend = "该玩家已是您好友啦",
    CannotAddSelf = "不能添加自己为好友",
    DeleteFriendTips = "确定与%s解除好友关系？",
    FriendInputDefault = "请输入好友名称搜索添加",

    ------------------------------------结算提示------------------------------------------
    FakeBossTips = "["..ColorFilter.Color_51BF53.."]很遗憾,您击杀的是首领假身[-]",
    RealBossTips = "["..ColorFilter.Color_D53E52.."]恭喜击杀首领真身,获得海量奖励[-]",
    TakeBossDamageTips = "您对BOSS造成了["..ColorFilter.Color_D53E52.."]%0.2f%%[-]伤害",
    Iknow = "我知道了",
    OperationTip = "操作提示",
    OperationTip1 = "拇指选择摇杆移动角色",
    OperationTip2 = "触碰攻击按钮打击对手",

    ---------------------------UpInfoPrompt-------------------------------------------
    UpGrade = "升级了!",
    WouldOpen = "即将开放",
    MyServer = "我的服务器",
    WouldLevel = "达到等级",
    HaveRole = "拥有角色",

    SDCardNotFound = "未检测到SD卡，请插入SD卡后重试",
    FreeStorage="存储空间不足，请准备至少200MB可用空间",
    CopyData =  "构建您的王者世界，不消耗流量",
    UnzipData = "正在解压文件，请不要关闭游戏",
    ConnectError2 = "网络无法连接，请检查后再开始游戏",
    DownloadingData = "正在玩命更新%s/%sMB数据，请稍后",
    DownloadingSize = "%s/%sMB",
    PackageError = "安装包不完整，请重新下载安装",
    CheckUpdate="正在检查更新",
    DownloadAPK ="有新的客户端需要更新，请下载安装",
    NeedUpdate="有新的版本更新",
    ReadUpdate="有%sMB资源需要更新",
    ReadUpdateAPK="有新的版本更新，安装包大小%sMB,下载后请安装",
    ------------------------------充值 VIP--------------------------------
    VipInfo = "查看特权",
    NeedCharge = "再充值[D1AD4B]%d元[-]即可成为 [D1AD4B]VIP%d[-]",
    ChargeFailed = "充值失败怎么办？",
    CurrentVipLevel = "当前等级：",
    VipMaxLevel = "您的VIP等级已满",
    ChargeFailedTitle = "客服微信：",
    VipAward = "VIP%d礼包",
    leftMonthCardTip = "    剩余%d天\n每天领120蓝钻",
    GotoCharge = "充值",
    VipTitle = "VIP%d会员特权",
    VipTips = "到达["..ColorFilter.Color_D2A848.."]VIP%d[-]后可在奖励领取",
    ChargeRecommand = "推荐",
    ChargePurchaseLimit = "限购",
    DiamondTips = "红钻可代替蓝钻使用",
    HowMuchRedDiamond = "%d 蓝钻",
    ArriveMuchCanGet = "到达 %d 级可以领取",

    -----------------------------SecretShop-----------------------------
    OneTakeOff = "开启一次",
    TenTakeOff = "开启十次",
    DayTakeOffCount = "今天开启次数:%d",
    FreeTakeOff = "免费开启一次\n(%d/%d)",
    SecretBox = "神秘宝箱",
    -----------------------------ActiveCode-----------------------------
    PlayerInfo = "玩家信息",
    ActiveCodeState = {
        [-1] = "未知错误",
        [1] = "您的兑换码成功使用成功",
        [-100] = "参数不完整",
        [-1406] = "账号不存在",
        [-1414] = "您已经领取过同类型的兑换码",
        [-1481] = "您输入的兑换码不存在",
        [-1482] = "您输入的兑换码已使用",
        [-1483] = "您输入的兑换码已过期",
        [-1505] = "活动时间结束",
        [-1553] = "您输入的兑换码条件不足,无法兑换",
        [-10106] = "实物卡未绑定,无法兑换",
    },
    Look = "查看",

    -------------------------------送鲜花，砸鸡蛋----------------------------
    Flower = "鲜花",
    FlowerUnit = "朵鲜花",
    Egg = "鸡蛋",
    EggSmell = "臭鸡蛋",
    EggUnit = "个臭鸡蛋",
    SendFlower = "送鲜花",
    FlowerTotal = "魅力值:",
    SendFlowerDoc = "送鲜花规则",
    CrackEggDoc = "砸鸡蛋规则",
    CrackEgg = "砸鸡蛋",
    CrackEggSuccessGet = "对方魅力值-%d",
    LingeringFragrance = "余香",
    RemainAwardTimes = "今日剩余奖励次数:",
    SendFlowerHelpInfo = "[3894D0]活动时间：\n[-]"..
                        "每日全天\n\n"..
                        "[3894D0]送花规则：\n[-]"..
                        "送花奖励次数：玩家给不同的角色首次送花，会扣除一次奖励次数，并获得相应的精力值奖励。\n"..
	                    "1朵/9朵鲜花：有送花奖励次数时才可赠送，且对同一角色只能赠送一次。\n"..
	                    "99朵鲜花：可不限角色，不限次数赠送。\n"..
						"玩家没有送花奖励次数，或对同一角色重复送花，都将不再获得精力值奖励。\n",
    CrackEggHelpInfo = "[3894D0]活动时间：\n[-]"..
                        "每日全天\n\n"..
                        "[3894D0]砸鸡蛋规则：\n[-]"..
                        "砸鸡蛋没有限制次数。\n"..
	                    "角色魅力值为负时，系统将禁止其在世界频道聊天，直到魅力值恢复到0或0以上。\n"..
	                    "角色魅力为负时，每负1点魅力值就会在世界聊天频道被禁言5秒。\n"..
						"魅力值为负时，每在线1分钟增加12点魅力值，增加到0后停止增加。\n",
    Gift = "赠送",
    GiftedOver = "["..ColorFilter.Color_51BF53.."]今日已赠送[-]",
    GiftedOverBtn = "已赠送",
    GiftedVipNeed = "["..ColorFilter.Color_D53E52.."]需要:VIP%d[-]",
    GiftedNone = "["..ColorFilter.Color_D53E52.."]不再获得奖励[-]",
    GiftedTimesNone = "["..ColorFilter.Color_51BF53.."]今日不可再赠送[-]",
    GiftedSendSuccess = "赠送成功",
    GiftedSendSuccessTips = "赠送成功,您获得:%d%s,%d%s",
    CreakSuccessTips = "成功使用%d个臭鸡蛋砸向【%s】使其的魅力值-%d",
    FlowerLogLessInfo = "["..ColorFilter.Color_51BF53.."]【%s】[-]向【%s】赠送了 ["..ColorFilter.Color_D53E52.."]%d朵鲜花[-] 使其魅力大增 ["..ColorFilter.Color_808A94.."]%s[-]",
    FlowerLogMiddleInfo = "【%s】向【%s】赠送了%d朵鲜花,使其魅力大增",
    FlowerLogMultiInfo = "【%s】向【%s】赠送了%d朵鲜花,使其魅力大增",
    FlowerLess = "1朵",
    FlowerMiddle = "9朵",
    FlowerLM = "1/9朵",
    FlowerMulti = "99朵",
    FlowerLook = "鲜花日志",
    FlowerRank = "鲜花周榜",
    EggLogLessInfo = "["..ColorFilter.Color_51BF53.."]【%s】[-]向【%s】扔了["..ColorFilter.Color_D53E52.."]%d个臭鸡蛋[-] 使其魅力值-%d ["..ColorFilter.Color_808A94.."]%s[-]",
    FlowerSysIsNotOpen = "鲜花功能10级才开启哦",
    EggSysIsNotOpen = "砸鸡蛋功能10才开启哦",
    FlowerCannotSendSelf = "不能给自己赠送鲜花",
    EggCannotCrackSelf = "您不能对自己砸鸡蛋",
    GiftedBackOver = "已赠送",

    ---------------------------充值活动--------------------------
    ChargeActivity = "精彩活动",
    TotalCharge = "累计充值",
    GotoAward = "去领取",
    ActivityContent = "活动内容:\n%s",
    ChargeFirst = "首充礼包",
    ChargeFund = "10倍基金",
    ChargeImmediate = "立即充值",
    GetChargeAward = "领取奖励",
    Perfect = "绝版",
    BuyImmediate = "立即购买",
    BuyedFund = "已购买",
    BuyFundTips = "购买基金花费500蓝钻",
    NeedVipCanBuy = "VIP%d可购买",
    NeedVipCanBuyTips = "需Vip%d可购买，请提升Vip等级！",
    ----------------------------称号------------------------------
    Title = "称号",
    FlowerTitle = "鲜花称号",
    LadderTitle = "骑士团称号",
    ActiveTitle = "活动称号",
    GetTitleCondition = "获取条件",
    TitleEffect = "称号效果",
    TitleTime = "称号时限",
    EquipTitle = "已佩戴",
    AllTimeEnable = "永久有效",
    GetTitle = "获取称号",
    TitleLoad = "佩戴",
    TitleUpLoad = "卸下",
    TitleTimeFormat = "%s天%s小时%s分",
    CongratulateTitle = "恭喜获得%s称号",
    SpecialTitle = "根据魅力值决定称号时限",
    ------------------------------SevenDay---------------------
    SevenDayActive = "七日豪礼",
    AwardPreview = "奖励预览",
    AwardPreviewTips = "本日完成目标越多，奖励越多！",
    SevenDayTypeText = {
        [1] = "等级突破",
        [2] = "主线副本",
        [3] = "圣器试炼",
        [4] = "精灵培养",
        [5] = "王者之路",
        [6] = "圣器符文",
        [7] = "魔魂升级",
        [8] = "魔魂突破",
        [9] = "魔魂商店刷新",
        [10] = "魔魂商店购买",
        [11] = "精灵突破",
        [12] = "魔魂突破",
        [13] = "等级突破",
        [14] = "战力突破",
        [15] = "精灵等级",
        [16] = "圣器强化",
        [17] = "火圣器",
        [18] = "魔魂试炼",
        [19] = "魔魂试炼",
    },
    DayTypeText = {
        [1] = "第一天",
        [2] = "第二天",
        [3] = "第三天",
        [4] = "第四天",
        [5] = "第五天",
        [6] = "第六天",
        [7] = "第七天",
    },
    ActiveEnd = "活动结束：",
    AwardEnd = "领奖结束：",
    PleaseChooseAwardTips = "请选择一个奖励",
    ToHallowFuWenTip = "未装备圣器！",
    SevenDayActiveEnd = "活动已结束！",
    SevenDayAwardTips = "橙魔魂",
    ------------------------------serverList---------------------
    NewServer = "["..ColorFilter.Color_51BF53.."] (新区)[-]",
    HotServer = "["..ColorFilter.Color_D53E52.."] (火爆)[-]",

    Skip = "跳过",
    GameWarning = "抵制不良游戏，拒绝盗版游戏。注意自我保护，谨防受骗上当。适度游戏益脑，沉迷游戏伤身。合理安排时间，享受健康生活。",
    PlaseSelectServer = "请选择服务器",
    ----------------------------message 小信封-----------------------
    NewMessage = "最新消息",
    IgnoreOneKey = "一键忽略",
    PushMessage = "",

    ---------------------------军团战淘汰赛---------------------------
    CorpsBattleNeedLevelTips = "骑士团等级达到3级才可参加军团战",
    CorpsBattleHasStart = "军团战已正式开始，无法参加比赛了",
    CorpsBattleReadyTips = "军团即将开始，请耐性等待",
    KnockoutHelpTips = "[3894D0]入围赛：\n[-]"..
	    	                "1.参与条件：骑士团等级≥3级，角色等级≥35级\n"..
							"2.开放时间：每周周二21:00——21:10\n"..
							"3.活动开放时间内，在骑士团领地中不断的刷出幽灵军团\n"..
							"4.击杀幽灵军团可获得丰厚的个人奖励和骑士团联赛积分\n"..
							"5.骑士团联赛积分排名前16名的军团可入围军团联赛淘汰赛\n\n"..
							"[3894D0]淘汰赛：\n[-]"..
							"1.参与条件：在入围赛活动中获得入围资格的骑士团\n"..
							"2.开放时间：每周周三、周四、周五、周六21:00——21:20\n"..
							"3.21:00——21:05为准备阶段，21:05——21:20为正式比赛阶段\n"..
							"4.正式比赛之后在准备阶段没有进入的角色将失去比赛资格\n"..
							"5.周三为8强赛，胜利的骑士团获得四强赛的资格，失败的将被淘汰\n"..
							"6.周四为4强赛，胜利的骑士团获得半决赛的资格，失败的将被淘汰\n"..
							"7.周五为半决赛，胜利的骑士团获得决赛的资格，失败的将被淘汰\n"..
							"8.周六为决赛，最终决出冠军\n\n"..
    	                   	"[3894D0]入围赛奖励：\n[-]"..
    						"1.入围赛中击杀幽灵军团可获得大量经验、金币与随机魔魂奖励\n"..
    						"2.骑士团中根据积分排名还可获得海量金币奖励\n\n"..
    						"[3894D0]淘汰赛奖励：\n[-]"..
    						"1.在淘汰赛比赛场地中每10秒可获得一次经验奖励\n"..
							"2.在淘汰赛中每进行一次战斗都可获得一定的金币奖励\n"..
							"3.每周骑士团联赛结算后，根据骑士团排名情况，每个参与角色都将获得保底石奖励\n"..
							"4.最终获得胜利的骑士团成员，将获得特殊称号奖励\n"..
							"5.最终获得胜利的骑士团团长的模型将出现在王城中获得大家的膜拜\n",
    KnockoutAwardTips = "[3894D0]骑士团联赛军团排名奖励：\n[-]"..
    	                    "[d7752d]团长奖励[-]\n"..
							"骑士团排名第1获得保底石*10\n"..
							"骑士团排名第2获得保底石*9\n"..
							"骑士团排名3、4获得保底石*8\n"..
							"骑士团排名5-8获得保底石*7\n"..
							"骑士团排名9-16获得保底石*6\n\n"..
							"[8758d7]副团长奖励[-]\n"..
							"骑士团排名第1获得保底石*9\n"..
							"骑士团排名第2获得保底石*8\n"..
							"骑士团排名3、4获得保底石*7\n"..
							"骑士团排名5-8获得保底石*6\n"..
							"骑士团排名9-16获得保底石*5\n\n"..
							"[3894d0]前锋与中锋奖励[-]\n"..
							"骑士团排名第1获得保底石*8\n"..
							"骑士团排名第2获得保底石*7\n"..
							"骑士团排名3、4获得保底石*6\n"..
							"骑士团排名5-8获得保底石*5\n"..
							"骑士团排名9-16获得保底石*4\n\n"..
							"[51bf53]团员奖励[-]\n"..
							"骑士团排名第1获得保底石*7\n"..
							"骑士团排名第2获得保底石*6\n"..
							"骑士团排名3、4获得保底石*5\n"..
							"骑士团排名5-8获得保底石*4\n"..
							"骑士团排名9-16获得保底石*3\n\n"..
						"[3894D0]奖励发放时间：\n[-]"..
						    "每周六夺城战结束后统一发放，通过奖励界面领取",
    AwardTips = "排名奖励",
    TakeMatch = "参赛",
    Knockout = "联赛",
    KnockoutDoing = "["..ColorFilter.Color_51BF53.."]进行中[-]",
    KnockoutOver = "["..ColorFilter.Color_D53E52.."]已结束[-]",
    CombatResult = "战报",
    CombatMember = "出席成员",
    CorpsInspire = "军团鼓舞",
    CorpsKnockOutTitle = "战场",
    CorpsKnockOutTitleCommon = "战场",
    CorpsKnockOutTimes = "距比赛开始：%d分%d秒",
    CorpGVGStartTimeCount = "比赛剩余时间：%d分%d秒",
    GVGTimeHint = "军团联赛-%s进行中",
    GVGTimeHint1 = "距活动结束：%d分%d秒",
    CorpsName = "【%s】",
    CorpsMemberLeft = "%d/%d",
    CorpsMemberLeftTitle = "剩余",
    CorpsFJoinMembers = "我方出席成员",
    CorpsEJoinMembers = "敌方出席成员",
    CorpsField = "所在场地",
    CorpsFightCount = "战斗场次",
    CorpsFightResult = "【%s】的【%s】将【%s】的【%s】打倒在地",
    GVGInspireHint = "本次军团战中军团成员战斗获得的金钱获得加成",
    GVGInspireCellHint = "【%s】花费%d钻石鼓舞,鼓舞等级升到了%d级",
    GVGInspireHint = "本次军团战中军团成员战斗获得的金币加成",
    GVGBattleResultTitle = "骑士团联赛",
    GVGBattleResultWin = "恭喜您的军团在本次军团战中获得了胜利",
    GVGRewardAllTitle = "总共获得：",
    GVGBattleResultLose = "很遗憾你的军团在本次军团战中惜败对手",
    GVGGameOver = "很遗憾，你的骑士团联赛积分剩余为0：被淘汰出局",
    GVGKnockOutTitle = "入围赛",
    GVG8Fight = "八强赛",
    GVG4Fight = "四强赛",
    GVG2Fight = "半决赛",
    GVGFinal = "夺城战",
    CorpsKnockOutHelp = "[3894D0]玩法介绍：\n[-]"..
    	                    "1.每个参与角色获得5颗参赛积分\n"..
							"2.每战斗失败一场减少一颗参赛积分\n"..
							"3.参赛积分为0时，即会被踢出赛场，失去参赛资格\n"..
							"4.当对手方的总参赛积分为0时，即可获得比赛的胜利\n"..
							"5.到达活动结束时间，双方积分均不为0，则积分多的一方获胜\n\n"..
							"[3894D0]战斗介绍：\n[-]"..
							"1.比赛双方的成员通过碰撞的方式进入战斗\n"..
							"2.战斗结束，胜负双方角色都会获得一定的保护时间\n"..
							"3.保护时间内不可主动攻击他人，也不可受到攻击\n\n"..
    	                   	"[3894D0]活动奖励：\n[-]"..
    						"1.场内的角色每间隔10秒可获得一定的经验奖励\n"..
    						"2.每参加一场战斗，无论胜负都可获得一定的金币奖励\n"..
    						"3.未达到活动结束时间即战败对手，场内玩家立即获得剩余时间的经验奖励\n\n"..
    						"[3894D0]军团鼓舞：\n[-]"..
    						"1.使用军团鼓舞可大幅提高单场战斗获得的金币奖励\n",
    CorpsOriBattleIsGoing = "军团领地中有大批黑曜军团士兵，快去绞杀吧",
    CorpsNotData = "轮空",
    CorpsBattleWiner = "王城守护者",
    CorpStatusDialog = "恭喜【%s】骑士团的全体成员，在骑士团联赛中表现出色获得了王城的守护权。",
    CorpsKnockoutWinerMapTip = "["..ColorFilter.Color_F7C45D.."]守护骑士团: \\<%s\\>[-]",
    CorpsKnockoutVectory = "["..ColorFilter.Color_D2A848.."]胜[-]",
    CorpsKnockoutDefeat = "["..ColorFilter.Color_808A94.."]负[-]",

----------------------KingTower-----------------------------
    KingTowerLeftTime = "比赛剩余时间",
    KingTowerMyTips = "己方",
    KingTowerEnemyTips = "敌方",
    KingTowerVictory = "胜负",
    KingTowerKill = "击杀",
    KingTowerKill2 = "[d53e52]击杀[-] ",
    KingTowerKillTower = "推塔",
    KingTowerPoint = "积分",
    KingTowerRelive = "复活倒计时",
    KingTowerMyself = "己方",
    KingTowerEnemy = "敌方",
    KingTowerDead = "死亡",
    KingTowerDead2 = "[51bf53]死亡[-] ",
    InviteMemberBtn = "雇佣团员",

    ----------------推送-----------
    SinewLunch="精灵午餐已准备就绪，快来和小伙伴们一起享用吧！",
    Tulong="屠龙战纪将于5分钟之后开启，快拿起武器击败终极大龙",
    SinewRestore="精力已满,快去扫荡精英副本吧",
    WipeRestore="您积攒了好多魔法书，快快领取升级吧",
}

TextSever = {
	[-1] = "错误",
	[-100] = "无效参数",
	[-200] = "数据库错误",
	[-201] = "网络异常，请稍候再试",
	[-202] = "服务器忙，请稍候再试",
	[-1444] = "蓝钻不足",
	[-1445] = "红钻不足",
	[-100003] = "帐号已存在",
	[-100004] = "帐号不存在",
	[-100005] = "用户名已存在",
	[-100006] = "密码错误",
	[-100007] = "用户名格式不对",
	[-100008] = "密码格式不对",
	[-100009] = "角色名包含敏感字符",
	[-100010] = "密码和确认密码不相等",
	[-100011] = "已达到最大角色数",
	[-100012] = "验证失败",
	[-100013] = "返回数据格式错误",
	[-100014] = "帐号被冻结",
	[-100015] = "本地认证失败",
	[-100016] = "角色不存在",
	[-100017] = "帐号不能绑定",
	[-100018] = "邮箱格式错误",
	[-100025] = "不支持的登陆类型",
	[-100026] = "不支持的注册类型",
	[-100027] = "用户名格式不对,请输入英文(10个)、数字(10个)或中文(6个)",
	[-100028] = "该职业已有角色",
	[-20000] = "无效的玩家状态",
	[-20001] = "初始化数据错误",
	[-20002] = "帐号已在其它位置登录",
	[-20003] = "频繁发送聊天消息",
	[-20004] = "访问数据文件错误",
	[-20005] = "无法生成流水号",
	[-20006] = "消息长度错误",
	[-20007] = "玩家不存在",
	[-20008] = "无法获取奖励",
	[-20009] = "服务器爆满，请选择其他服务器",
	[-20010] = "玩家被禁言",
	[-20011] = "操作失败",
	[-20012] = "数量不够",
	[-20021] = "道具不存在",
	[-20022] = "道具不能出售",
	[-20023] = "职业不匹配",
	[-20024] = "未穿戴装备",
	[-20025] = "不能洗练",
	[-20026] = "经验不足",
	[-20027] = "超过升星最大等级",
	[-20041] = "级别不够",
	[-20042] = "vip等级不足",
	[-20043] = "当日购买次数已达上限，请提升vip等级",
	[-20052] = "超过最大强化等级",
	[-20053] = "未达到强化等级",
	[-20054] = "未达到玩家等级",
	[-20055] = "材料不足",
	[-20056] = "装备等级不够",
	[-20057] = "装备品质不够",
	[-20061] = "超过培养最大进度",
	[-20062] = "正在激活,请稍等",
	[-20063] = "设置精灵出战数量异常",
	[-20064] = "错误的精灵装备id",
	[-20065] = "装备位置已经穿装备了",
	[-20066] = "升级装备不够",
	[-20067] = "超过最大新级等级",
	[-20068] = "装备不能合成",
	[-20069] = "精灵出战状态异常",
	[-20070] = "精灵出战未解锁",
	[-20071] = "未达到历史最高强化等级",
	[-20072] = "消耗圣器等级不一致",
	[-20073] = "符文位置没有解锁",
	[-20074] = "符文强化消耗数量错误",
	[-20075] = "错误的分解等级",
	[-20076] = "错误的提炼等级",
	[-20077] = "圣器位置没有解锁",
	[-20078] = "玩家等级低于圣器等级",
	[-20079] = "达到符文最大等级",
	[-20081] = "金币不足",
	[-20082] = "灵力不足",
	[-20083] = "天赋点不足",
	[-20084] = "精力不足",
	[-20085] = "晶石不足",
	[-20086] = "荣誉不足",
	[-20087] = "屠龙币不足",
	[-20088] = "千层塔币不足",
	[-20100] = "普通背包已满",
	[-20101] = "装备背包已满",
	[-20102] = "精灵背包已满",
	[-20103] = "圣器背包已满",
	[-20104] = "宝石背包已满",
	[-20105] = "魔魂背包已满",
	[-20106] = "符文背包已满",
	[-20201] = "主城未开启",
	[-20202] = "主城不存在",
	[-20250] = "技能尚未解锁",
	[-20251] = "技能已达最大等级",
	[-20252] = "天赋尚未解锁",
	[-20253] = "天赋已达最大等级",
	[-20254] = "未解锁任何天赋",
	[-20300] = "不存在该魔魂",
	[-20301] = "该位置尚未开启",
	[-20302] = "该魔魂未出战",
	[-20303] = "不存在该魔魂碎片",
	[-20304] = "魔魂碎片不足",
	[-20305] = "魔魂背包已满",
	[-20306] = "魔魂等级不能超过角色等级",
	[-20307] = "魔魂升级材料不足",
	[-20308] = "已突破过的魔魂不能被吞噬",
	[-20309] = "已升星过的魔魂不能被吞噬",
	[-20310] = "魔魂已突破至最高级",
	[-20311] = "请先升级魔魂",
	[-20312] = "魔魂突破材料不足（突破丹可以从魔魂试炼获得）",
	[-20313] = "该魔魂装备不需要合成",
	[-20314] = "该魔魂装备已装备",
	[-20315] = "该魔魂装备已最高级",
	[-20316] = "尚未穿满装备",
	[-20317] = "魔魂已出战",
	[-20318] = "魔魂不能分解",
	[-20319] = "魔魂背包已满",
	[-20320] = "魔魂抽卡时间未到",
	[-20321] = "该道具已购买",
	[-20322] = "魔魂商店类型为空",
	[-20323] = "魔魂试炼次数不足",
	[-20324] = "不能购买了",
	[-20325] = "不能出战相同技能魔魂",
	[-20328] = "条件不符合",
	[-20329] = "无此奖励",
	[-20330] = "已领取",
    [-20333] = "金币抽卡次数不足",
    [-20335] = "购买次数不足",
    [-20337] = "VIP等级不足，魔魂商店无法刷新",
    [-20338] = "魔魂商店刷新次数已达上限",
    [-20340] = "魔魂等级不够不能升星",
	[-20400] = "任务不存在",
	[-20401] = "任务已交接",
	[-20402] = "任务未完成",
	[-20403] = "任务已接取",
	[-20404] = "任务不可接",
	[-20405] = "任务未解锁",
	[-20600] = "关卡通过异常",
	[-20601] = "关卡星级奖励状态错误",
	[-20602] = "关卡扫荡次数错误",
	[-20603] = "关卡扫荡类型错误",
	[-20604] = "关卡没达到扫荡星级",
	[-20605] = "关卡不可以复活",
	[-20606] = "关卡没有解锁",
	[-20607] = "关卡扫荡奖励已经领取",
	[-20608] = "关卡扫荡炼金收取错误",
	[-20609] = "关卡扫荡卷错误",
	[-20610] = "日常关卡次数异常",
	[-20611] = "日常关卡倒计时异常",
	[-20612] = "圣器试炼难度没有解锁",
	[-20613] = "玩家在其他房间中，不能加入房间",
	[-20614] = "进入房间密码错误",
	[-20615] = "房间满了",
	[-20616] = "房间状态异常",
	[-20617] = "玩家已经在房间里面了",
	[-20618] = "玩家不在房间里",
	[-20619] = "房间不存在",
	[-20620] = "房间类型不存在",
	[-20621] = "房间不匹配",
	[-20622] = "操作类型不存在",
	[-20623] = "已达购买上限，继续购买请提升VIP等级",
	[-20624] = "不是房间创建者",
	[-20625] = "没有可自动加入的房间",
	[-20626] = "有成员金币不足以挑战全部关卡",
	[-20627] = "该房间已经开始挑战",
	[-20628] = "世界邀请过于频繁",
	[-20629] = "主线关卡每日挑战次数已达上限",
    [-20632] = "今天已经被雇佣过了",
	[-20701] = "时装幻化进阶等级错误",
	[-20702] = "时装超过最大等级",
	[-20703] = "已经存在此时装，不能购买",
	[-20704] = "时装不存在",
	[-20705] = "时装购买玩家等级不够",
	[-20706] = "vip等级不足，无法购买时装",
	[-20707] = "需要先购买上一星级时装",
    [-20708] = "时装不能购买",
	[-20800] = "没有该成就",
	[-20801] = "成就奖励已领取",
	[-20802] = "成就还未完成",
	[-20850] = "炼金没有次数了",
	[-20855] = "精力购买没有次数了",
	[-20856] = "精力已满",
	[-20861] = "重复添加好友",
	[-20862] = "不存在该角色",
	[-20863] = "不能添加自己为好友",
	[-20864] = "您的好友列表已满，无法添加",
	[-20865] = "对方等级不足无法加为好友",
	[-20866] = "对方不是好友",
	[-20900] = "没有该奖励",
	[-20920] = "没有该奖励",
	[-20921] = "已奖励",
	[-21000] = "宝石位置没有解锁",
	[-21001] = "未穿戴宝石",
	[-21002] = "多彩宝石不能合成",
	[-21003] = "没有达到开锁等级",
	[-21004] = "已经达到最高等级",
	[-21100] = "vip等级不足",
	[-21101] = "洞悉敌情次数不足",
	[-21102] = "有玩家正在打当前npc",
	[-21104] = "勋章不足",
	[-21105] = "召魔令不足",
	[-21106] = "VIP达到3级才能洞悉敌军",
	[-22000] = "屠龙战纪活动在每日20:00开启",
	[-22001] = "已经有支持者了",
	[-22002] = "支持者不存在",
	[-22003] = "没到竞猜时间",
	[-22004] = "没到鼓舞时间",
	[-22005] = "当前玩家不能领取奖励",
	[-22006] = "已经领取奖励",
	[-22007] = "冷却时间未到",
	[-22008] = "玩家不在骑士团中",
	[-22009] = "骑士团中已经有玩家鼓舞过了",
	[-22020] = "错误的攻击顺序",
	[-22021] = "关卡还没有通关",
	[-22022] = "奖励已经领取",
	[-22050] = "不存在该排行榜",
	[-22051] = "排行榜正在更新",
	[-22052] = "最多只能设置三个排行榜头衔",
	[-25300] = "达到当日最大使用次数",
	[-25301] = "奖励已领取",
	[-25302] = "奖励领取失败",
	[-25303] = "活动未开启",
	[-25304] = "活动次数已用完",
	[-203022] = "活动已经过期",
	[-203023] = "手机号或微信号长度不符合或为空",
	[-203024] = "您未进行付费无法领取红包",
	[-203025] = "您的游戏账号已申请过红包",
	[-203026] = "您的微信号已申请过红包",
	[-203027] = "您的手机号已申请过红包",
	[-203028] = "您的设备已申请过红包",
	[-203029] = "此用户已发送过",
	[-203030] = "此电话号码已发送过",
	[-203031] = "此MAC已发送过",
	[-201381] = "您当日在线游戏时间不足，请先继续游戏！",
	[-201382] = "您当前角色等级不足，请提升角色等级！",
	[-201383] = "补偿领取错误",
	[-30200] = "当日次数已用完",
	[-30201] = "冷却时间未到",
	[-30100] = "尚未加入骑士团",
	[-30101] = "已经存在骑士团",
	[-30102] = "加入多个骑士团",
	[-30103] = "骑士团已经被删除了",
	[-30104] = "不是团长",
	[-30106] = "骑士团名称不符合格式",
	[-30107] = "已加入骑士团",
	[-30108] = "未达到招募条件，无法申请",
	[-30109] = "骑士团人数已满，无法加入新的成员",
	[-30110] = "已经申请该骑士团",
	[-30111] = "最多只能同时申请三个骑士团",
	[-30112] = "骑士团最多只接受50个申请",
	[-30113] = "不是管理员",
	[-30114] = "未加入骑士团",
	[-30115] = "骑士团长不能退出骑士团",
	[-30116] = "不能踢团长",
	[-30117] = "不能踢自己",
	[-30118] = "不在同一骑士团",
	[-30119] = "骑士团团长不能删号，请先卸任团长",
	[-30120] = "本职务成员数量已达上限",
	[-30121] = "骑士团介绍文字过长",
	[-30122] = "不能转让给自己",
	[-30123] = "频繁发送招募消息",
	[-30124] = "骑士团等级不足",
    [-30125] = "骑士团名包含敏感字符",
    [-30126] = "军团战期间不能进行此操作",
	[-30150] = "未创建占星师",
	[-30151] = "当日占星次数已用完",
	[-30152] = "骑士团当日名额已用完",
	[-30250] = "无此矿洞",
	[-30251] = "无挖矿名额了",
	[-30252] = "无挖矿次数了",
	[-30253] = "已在挖矿",
	[-30254] = "无奖励",
	[-30255] = "请先领奖",
	[-30257] = "该矿工已经被掠夺干净了",
	[-30500] = "活动未开启",
	[-30501] = "重复领奖",
	[-30502] = "无法购买奖品",
	[-30503] = "已鼓舞到最大级别",
	[-30504] = "其它玩家已鼓舞",
	[-30505] = "你没有领取奖励的资格",
	[-30506] = "骑士团等级达到2级开放此活动",
	[-30507] = "结束前60秒无法进入",
    [-30508] = "你的骑士团没有本次活动的参赛资格",
	[-30509] = "不能进行扫荡了",
	[-30511] = "VIP达到1级才能进行鼓舞",
    [-20630] = "返回主城才能加入队伍",
    [-30510] = "达到最大层数",
    [-30600] = "驯兽boss没有解锁",
	[-30601] = "驯兽boss已经被驯服",
	[-30602] = "有玩家正在进行挑战，请稍后再来",
	[-30603] = "骑士团驯兽次数不足",
	[-30604] = "没有达到进入等级",
	[-30605] = "boss被驯服后才可兑换",
	[-30606] = "没有兑换次数",
	[-30607] = "兑换的物品不足",
	[-30608] = "今日驯兽活动已结束",
	[-30609] = "进度商店物品未解锁",
	[-30610] = "骑士团金币不足",
	[-30611] = "申请者不是本人",
	[-30612] = "昨日没有进度消息",
	[-30613] = "您的职位太低，请联系军团长提升",
	[-30614] = "驯兽骑士团仓库已满",
	[-30615] = "骑士团贡献不足",
	[-30650] = "秘宝商人抽卡时间未到",
	[-30651] = "神秘宝箱开启次数不足",
    [-30800] = "今日已签到",
	[-30801] = "没有需要补签的日期",
	[-30802] = "您本月有缺勤不能领取全勤奖励",
	[-30803] = "您已经领取本月的全勤奖励",
    [-30900] = "玩家未分组",
    [-30901] = "挑战时间不足",
    [-30902] = "精灵试炼还没开启",
    [-30903] = "精灵试炼已经结束",
    [-20089] = "符文背包剩余空间太小",
    [-30616] = "今日参与驯兽人数已满",
    [-30258] = "无掠夺次数了",
    [-30617] = "vip等级不足，无法进行骑士团Boss鼓舞",
    [-30700] = "月卡尚未到期，无法购买月卡",
    [-30701] = "首充奖励需角色等级达到9级后领取",
    [-20080] = "圣器背包空间太小",
    [-30300] = "世界服务器已停止",
    [-30301] = "今日购买次数不足，提升VIP可提高购买上限",
    [-30302] = "军团等级不足",
    [-30303] = "玩家等级不足",
    [-30304] = "需要VIP等级达到6级",
    [-30305] = "这个宝藏已被领取完",
    [-30306] = "您已领取",
    [-30307] = "已达寻宝次数储存上限",
    [-30308] = "寻宝次数不足",
    [-20631] = "等级不足",
    [-31000] = "数据异常",
    [-31001] = "不能给自己赠送鲜花",
    [-31002] = "vip等级不够",
    [-31003] = "每次赠送已达上限",
    [-31004] = "您今日已经赠送过了",
    [-31005] = "您不能对自己砸鸡蛋",
    [-31006] = "操作过快",
    [-31007] = "您的魅力值为负不可发言，魅力值为负时每5秒恢复一点",
    [-31008] = "玩家不存在",
    [-31009] = "等级不足功能未开放",
    [-31010] = "目标等级不足功能未开放",
    [-31011] = "不能回赠自己鲜花",
    [-31012] = "回赠记录不存在",
    [-31013] = "已经回赠",
    [-31014] = "不能回砸自己鸡蛋",
    [-30621] = "你的开孔符已经足够，无需再次兑换",
    [-31120] = "特殊称号不能卸载",
    [-31121] = "称号不存在",
    [-31122] = "称号失效",
    [-31123] = "该称号已经装备",
    [-31124] = "当前尚未装备任何称号",
    [-31125] = "当前称号不能被其他称号取代",
    [-21107] = "已达到今日最大挑战次数",
    [-20091] = "开启精炼功能",
    [-31100] = "你已经在军团战活动领地",
    [-31101] = "只有在准备阶段才能进入",
    [-31102] = "你的骑士团未进入此轮比赛",
    [-31103] = "玩家未参加比赛",
    [-31104] = "你的骑士团已经决出胜负了",
    [-31130] = "尚未否买基金",
	[-31131] = "等级尚未达到",
	[-31132] = "该阶段奖励已经领取",
	[-31133] = "已经购买过基金了",
	[-31134] = "完成首冲之后才能购买基金",
	[-31135] = "不存在该项奖励",
    [-31105] = "你已经被淘汰出局，不能进入战场了",
    [-31106] = "达到35级才可参加",
    [-31136] = "系统忙",
	[-31137] = "数据不存在",
	[-31138] = "吉时未到",
	[-31139] = "目标尚未达成",
	[-31140] = "超时",
	[-31141] = "活动已经结束",
	[-31142] = "奖励已经领取",
	[-31143] = "请选择心仪的奖励",
    [-31150] = "系统检测到非法程序，您不能继续游戏！",
    [-31151] = "系统检测到非法程序，本次战斗无奖励",
    [-30322] = "其他玩家未退出战斗",
}
